FIPS,stabb,state,Civilian_labor_force_2019,Employed_2019,Unemployed_2019,Unemployment_rate_2019,Median_Household_Income_2019,Med_HH_Income_Percent_of_State_Total_2019
1001,AL,"Autauga County, AL",26172,25458,714,3,58233,113
1003,AL,"Baldwin County, AL",97328,94675,2653,3,59871,116
1005,AL,"Barbour County, AL",8537,8213,324,4,35972,70
1007,AL,"Bibb County, AL",8685,8419,266,3,47918,93
1009,AL,"Blount County, AL",25331,24655,676,3,52902,102
1011,AL,"Bullock County, AL",4818,4643,175,4,31906,62
1013,AL,"Butler County, AL",9263,8925,338,4,39944,77
1015,AL,"Calhoun County, AL",46209,44574,1635,3,47747,92
1017,AL,"Chambers County, AL",15748,15286,462,3,42015,81
1019,AL,"Cherokee County, AL",11604,11266,338,3,45982,89
1021,AL,"Chilton County, AL",19818,19280,538,5,49692,96
1023,AL,"Choctaw County, AL",4670,4452,218,6,39808,77
1025,AL,"Clarke County, AL",7557,7121,436,3,43822,85
1027,AL,"Clay County, AL",6101,5918,183,3,40562,78
1029,AL,"Cleburne County, AL",5806,5623,183,3,51276,99
1031,AL,"Coffee County, AL",21402,20779,623,4,57299,111
1033,AL,"Colbert County, AL",23646,22761,885,4,46683,90
1035,AL,"Conecuh County, AL",4533,4353,180,3,41539,80
1037,AL,"Coosa County, AL",4549,4414,135,3,42024,81
1039,AL,"Covington County, AL",15653,15119,534,3,44836,87
1041,AL,"Crenshaw County, AL",6476,6293,183,3,43309,84
1043,AL,"Cullman County, AL",38646,37648,998,3,50897,98
1045,AL,"Dale County, AL",20724,20082,642,6,45120,87
1047,AL,"Dallas County, AL",14711,13904,807,3,34034,66
1049,AL,"DeKalb County, AL",31052,30182,870,3,44277,86
1051,AL,"Elmore County, AL",37565,36586,979,4,62310,120
1053,AL,"Escambia County, AL",14762,14248,514,3,42712,83
1055,AL,"Etowah County, AL",42723,41295,1428,3,43047,83
1057,AL,"Fayette County, AL",6579,6372,207,3,44212,85
1059,AL,"Franklin County, AL",14696,14291,405,3,44874,87
1061,AL,"Geneva County, AL",11045,10725,320,6,43089,83
1063,AL,"Greene County, AL",2883,2722,161,4,28699,55
1065,AL,"Hale County, AL",6119,5878,241,4,40745,79
1067,AL,"Henry County, AL",6944,6697,247,3,48597,94
1069,AL,"Houston County, AL",46234,44844,1390,3,50138,97
1071,AL,"Jackson County, AL",23484,22712,772,3,44322,86
1073,AL,"Jefferson County, AL",318755,309664,9091,3,54127,105
1075,AL,"Lamar County, AL",5849,5670,179,3,42686,83
1077,AL,"Lauderdale County, AL",42548,41160,1388,3,48188,93
1079,AL,"Lawrence County, AL",14306,13859,447,3,47797,92
1081,AL,"Lee County, AL",76580,74500,2080,3,54160,105
1083,AL,"Limestone County, AL",43854,42700,1154,6,64729,125
1085,AL,"Lowndes County, AL",3587,3383,204,4,33930,66
1087,AL,"Macon County, AL",7850,7513,337,3,34281,66
1089,AL,"Madison County, AL",185219,180505,4714,4,68609,133
1091,AL,"Marengo County, AL",7694,7423,271,3,38838,75
1093,AL,"Marion County, AL",12932,12486,446,3,44675,86
1095,AL,"Marshall County, AL",44085,42999,1086,4,48913,95
1097,AL,"Mobile County, AL",189107,182083,7024,5,49492,96
1099,AL,"Monroe County, AL",7329,6973,356,3,40005,77
1101,AL,"Montgomery County, AL",105777,102517,3260,3,52711,102
1103,AL,"Morgan County, AL",58271,56771,1500,5,54355,105
1105,AL,"Perry County, AL",3413,3235,178,4,29572,57
1107,AL,"Pickens County, AL",7923,7647,276,3,40249,78
1109,AL,"Pike County, AL",15428,14924,504,3,41271,80
1111,AL,"Randolph County, AL",9639,9347,292,3,42922,83
1113,AL,"Russell County, AL",23896,23198,698,3,43670,84
1115,AL,"St. Clair County, AL",40532,39441,1091,2,65403,126
1117,AL,"Shelby County, AL",115939,113414,2525,5,77801,150
1119,AL,"Sumter County, AL",4854,4635,219,3,29209,56
1121,AL,"Talladega County, AL",35769,34556,1213,3,47719,92
1123,AL,"Tallapoosa County, AL",18652,18096,556,3,47100,91
1125,AL,"Tuscaloosa County, AL",104964,102122,2842,3,52307,101
1127,AL,"Walker County, AL",25347,24517,830,5,45991,89
1129,AL,"Washington County, AL",6800,6487,313,7,48864,94
1131,AL,"Wilcox County, AL",2739,2544,195,3,30998,60
1133,AL,"Winston County, AL",10041,9705,336,6,40827,79
2013,AK,"Aleutians East Borough, AK",2428,2360,68,4,66923,87
2016,AK,"Aleutians West Census Area, AK",3606,3477,129,5,84726,110
2020,AK,"Anchorage Borough/municipality, AK",146949,139526,7423,13,82512,107
2050,AK,"Bethel Census Area, AK",7025,6120,905,6,48262,63
2060,AK,"Bristol Bay Borough, AK",441,414,27,9,87950,114
2068,AK,"Denali Borough, AK",1038,950,88,8,78434,102
2070,AK,"Dillingham Census Area, AK",1938,1781,157,5,57436,74
2090,AK,"Fairbanks North Star Borough, AK",44652,42248,2404,9,74076,96
2100,AK,"Haines Borough, AK",1111,1012,99,11,62548,81
2105,AK,"Hoonah-Angoon Census Area, AK",1160,1028,132,4,53141,69
2110,AK,"Juneau Borough/city, AK",16999,16243,756,7,85419,111
2122,AK,"Kenai Peninsula Borough, AK",26161,24383,1778,6,68625,89
2130,AK,"Ketchikan Gateway Borough, AK",6884,6456,428,6,75706,98
2150,AK,"Kodiak Island Borough, AK",5912,5582,330,19,79669,103
2158,AK,"Kusilvak Census Area, AK",2682,2164,518,10,35369,46
2164,AK,"Lake and Peninsula Borough, AK",708,638,70,7,51693,67
2170,AK,"Matanuska-Susitna Borough, AK",46901,43661,3240,11,75856,98
2180,AK,"Nome Census Area, AK",4036,3596,440,6,58464,76
2185,AK,"North Slope Borough, AK",3485,3261,224,14,84784,110
2188,AK,"Northwest Arctic Borough, AK",2934,2523,411,9,61660,80
2195,AK,"Petersburg Borough, AK",1388,1267,121,10,71296,92
2198,AK,"Prince of Wales-Hyder Census Area, AK",2851,2562,289,,50049,65
2201,AK,"Prince of Wales-Outer Ketchikan Census Area, AK",,,,4,,
2220,AK,"Sitka Borough/city, AK",4336,4155,181,9,80660,105
2230,AK,"Skagway Municipality, AK",822,746,76,,74898,97
2232,AK,"Skagway-Hoonah-Angoon Census Area, AK",,,,9,,
2240,AK,"Southeast Fairbanks Census Area, AK",2810,2558,252,8,69646,90
2261,AK,"Valdez-Cordova Census Area, AK",4815,4452,363,8,74574,97
2275,AK,"Wrangell Borough/city, AK",1002,925,77,,62496,81
2280,AK,"Wrangell-Petersburg Census Area, AK",,,,8,,
2282,AK,"Yakutat Borough/city, AK",246,227,19,14,61587,80
2290,AK,"Yukon-Koyukuk Census Area, AK",2458,2113,345,5,42063,55
4001,AZ,"Apache County, AZ",20487,18468,2019,6,35386,57
4003,AZ,"Cochise County, AZ",50594,47695,2899,6,48650,78
4005,AZ,"Coconino County, AZ",77507,73206,4301,6,58301,94
4007,AZ,"Gila County, AZ",21677,20485,1192,5,45980,74
4009,AZ,"Graham County, AZ",15351,14608,743,4,50685,82
4011,AZ,"Greenlee County, AZ",4520,4342,178,6,68066,110
4012,AZ,"La Paz County, AZ",9334,8789,545,4,39407,64
4013,AZ,"Maricopa County, AZ",2310503,2217656,92847,6,68634,111
4015,AZ,"Mohave County, AZ",87792,82815,4977,7,49712,80
4017,AZ,"Navajo County, AZ",40979,37973,3006,4,40676,66
4019,AZ,"Pima County, AZ",498695,476620,22075,5,56150,91
4021,AZ,"Pinal County, AZ",187480,178309,9171,9,62067,100
4023,AZ,"Santa Cruz County, AZ",19636,17963,1673,4,47779,77
4025,AZ,"Yavapai County, AZ",106880,102138,4742,16,54242,87
4027,AZ,"Yuma County, AZ",99824,83437,16387,4,47024,76
5001,AR,"Arkansas County, AR",9427,9141,286,5,52539,107
5003,AR,"Ashley County, AR",7751,7333,418,4,47744,97
5005,AR,"Baxter County, AR",16296,15646,650,3,41950,86
5007,AR,"Benton County, AR",137211,133610,3601,3,70775,144
5009,AR,"Boone County, AR",16036,15525,511,4,50083,102
5011,AR,"Bradley County, AR",4483,4298,185,4,39982,82
5013,AR,"Calhoun County, AR",2453,2345,108,3,48415,99
5015,AR,"Carroll County, AR",12783,12383,400,7,43841,89
5017,AR,"Chicot County, AR",3285,3057,228,4,37014,76
5019,AR,"Clark County, AR",9691,9323,368,5,44105,90
5021,AR,"Clay County, AR",5691,5413,278,5,40686,83
5023,AR,"Cleburne County, AR",9226,8808,418,4,46214,94
5025,AR,"Cleveland County, AR",3219,3092,127,5,53773,110
5027,AR,"Columbia County, AR",9140,8730,410,4,42964,88
5029,AR,"Conway County, AR",8285,7926,359,3,46924,96
5031,AR,"Craighead County, AR",55652,54097,1555,3,47766,97
5033,AR,"Crawford County, AR",26922,26028,894,4,44600,91
5035,AR,"Crittenden County, AR",21422,20512,910,4,41976,86
5037,AR,"Cross County, AR",7411,7097,314,5,45273,92
5039,AR,"Dallas County, AR",2840,2706,134,5,41314,84
5041,AR,"Desha County, AR",5402,5161,241,5,37005,76
5043,AR,"Drew County, AR",7864,7456,408,3,44162,90
5045,AR,"Faulkner County, AR",62431,60556,1875,3,58482,119
5047,AR,"Franklin County, AR",7494,7242,252,4,45670,93
5049,AR,"Fulton County, AR",4962,4763,199,4,32926,67
5051,AR,"Garland County, AR",41346,39809,1537,3,45786,93
5053,AR,"Grant County, AR",8403,8136,267,4,58566,120
5055,AR,"Greene County, AR",20065,19366,699,4,47098,96
5057,AR,"Hempstead County, AR",9951,9571,380,4,40867,83
5059,AR,"Hot Spring County, AR",14019,13509,510,3,45860,94
5061,AR,"Howard County, AR",5711,5525,186,4,41427,85
5063,AR,"Independence County, AR",16527,15868,659,6,47903,98
5065,AR,"Izard County, AR",4912,4643,269,7,40233,82
5067,AR,"Jackson County, AR",5840,5460,380,6,38636,79
5069,AR,"Jefferson County, AR",27740,26220,1520,5,40555,83
5071,AR,"Johnson County, AR",10278,9809,469,5,40396,82
5073,AR,"Lafayette County, AR",2466,2351,115,4,37164,76
5075,AR,"Lawrence County, AR",6817,6533,284,5,39604,81
5077,AR,"Lee County, AR",2833,2706,127,4,30421,62
5079,AR,"Lincoln County, AR",3950,3777,173,4,44272,90
5081,AR,"Little River County, AR",5518,5280,238,4,43257,88
5083,AR,"Logan County, AR",8583,8210,373,3,42249,86
5085,AR,"Lonoke County, AR",34468,33359,1109,3,62782,128
5087,AR,"Madison County, AR",7427,7238,189,4,48016,98
5089,AR,"Marion County, AR",6673,6406,267,4,38760,79
5091,AR,"Miller County, AR",19750,18941,809,5,50905,104
5093,AR,"Mississippi County, AR",17358,16467,891,4,39990,82
5095,AR,"Monroe County, AR",2761,2642,119,5,34289,70
5097,AR,"Montgomery County, AR",2970,2832,138,4,39591,81
5099,AR,"Nevada County, AR",3662,3517,145,4,36528,75
5101,AR,"Newton County, AR",3335,3218,117,5,37648,77
5103,AR,"Ouachita County, AR",9838,9330,508,4,46393,95
5105,AR,"Perry County, AR",4275,4100,175,6,50560,103
5107,AR,"Phillips County, AR",6379,5996,383,4,31521,64
5109,AR,"Pike County, AR",4250,4086,164,3,44426,91
5111,AR,"Poinsett County, AR",10279,9929,350,4,40536,83
5113,AR,"Polk County, AR",8121,7782,339,4,39722,81
5115,AR,"Pope County, AR",28869,27618,1251,4,47519,97
5117,AR,"Prairie County, AR",3586,3430,156,3,46205,94
5119,AR,"Pulaski County, AR",190248,183776,6472,4,52684,108
5121,AR,"Randolph County, AR",7301,7017,284,5,42875,88
5123,AR,"St. Francis County, AR",8197,7772,425,3,34389,70
5125,AR,"Saline County, AR",59114,57450,1664,3,66944,137
5127,AR,"Scott County, AR",4314,4167,147,5,38065,78
5129,AR,"Searcy County, AR",2914,2781,133,3,34712,71
5131,AR,"Sebastian County, AR",56698,54834,1864,5,48945,100
5133,AR,"Sevier County, AR",5513,5248,265,5,43493,89
5135,AR,"Sharp County, AR",5742,5457,285,5,37591,77
5137,AR,"Stone County, AR",4726,4503,223,5,36930,75
5139,AR,"Union County, AR",15847,15018,829,5,46602,95
5141,AR,"Van Buren County, AR",5741,5455,286,2,38096,78
5143,AR,"Washington County, AR",124967,121914,3053,5,52158,106
5145,AR,"White County, AR",33800,32281,1519,5,46388,95
5147,AR,"Woodruff County, AR",2773,2627,146,4,36568,75
5149,AR,"Yell County, AR",8417,8081,336,4,44469,91
6001,CA,"Alameda County, CA",844346,819675,24671,5,107589,134
6003,CA,"Alpine County, CA",551,523,28,4,58112,72
6005,CA,"Amador County, CA",14900,14328,572,5,62640,78
6007,CA,"Butte County, CA",99242,94162,5080,4,58394,73
6009,CA,"Calaveras County, CA",21428,20616,812,13,68248,85
6011,CA,"Colusa County, CA",10993,9586,1407,3,59048,73
6013,CA,"Contra Costa County, CA",561757,544496,17261,6,106555,133
6015,CA,"Del Norte County, CA",9674,9119,555,4,48979,61
6017,CA,"El Dorado County, CA",92022,88785,3237,7,86202,107
6019,CA,"Fresno County, CA",450760,418092,32668,6,56926,71
6021,CA,"Glenn County, CA",12997,12201,796,4,55682,69
6023,CA,"Humboldt County, CA",62507,60254,2253,18,51134,64
6025,CA,"Imperial County, CA",71411,58331,13080,4,48102,60
6027,CA,"Inyo County, CA",8760,8450,310,8,59605,74
6029,CA,"Kern County, CA",390999,360783,30216,8,53245,66
6031,CA,"Kings County, CA",57788,53222,4566,5,57297,71
6033,CA,"Lake County, CA",29158,27687,1471,5,46897,58
6035,CA,"Lassen County, CA",9869,9416,453,4,53613,67
6037,CA,"Los Angeles County, CA",5121584,4894296,227288,7,72721,90
6039,CA,"Madera County, CA",61945,57651,4294,2,61105,76
6041,CA,"Marin County, CA",139979,136786,3193,5,112069,139
6043,CA,"Mariposa County, CA",7612,7262,350,4,52760,66
6045,CA,"Mendocino County, CA",38934,37388,1546,8,52309,65
6047,CA,"Merced County, CA",116226,106866,9360,7,59733,74
6049,CA,"Modoc County, CA",3171,2947,224,4,45311,56
6051,CA,"Mono County, CA",8508,8195,313,6,66226,82
6053,CA,"Monterey County, CA",222516,208717,13799,3,76509,95
6055,CA,"Napa County, CA",74004,71900,2104,3,90230,112
6057,CA,"Nevada County, CA",48639,47022,1617,3,69550,87
6059,CA,"Orange County, CA",1623421,1578334,45087,3,95761,119
6061,CA,"Placer County, CA",187932,182093,5839,8,97688,122
6063,CA,"Plumas County, CA",7903,7296,607,4,59376,74
6065,CA,"Riverside County, CA",1104035,1057884,46151,4,72905,91
6067,CA,"Sacramento County, CA",712394,686298,26096,5,71891,89
6069,CA,"San Benito County, CA",31432,29845,1587,4,84209,105
6071,CA,"San Bernardino County, CA",967719,930709,37010,3,67398,84
6073,CA,"San Diego County, CA",1590591,1539948,50643,2,83576,104
6075,CA,"San Francisco County/city, CA",583186,570412,12774,6,121795,151
6077,CA,"San Joaquin County, CA",327077,307854,19223,3,68458,85
6079,CA,"San Luis Obispo County, CA",140931,136914,4017,2,76599,95
6081,CA,"San Mateo County, CA",460044,450647,9397,4,135234,168
6083,CA,"Santa Barbara County, CA",217882,209843,8039,3,74530,93
6085,CA,"Santa Clara County, CA",1053723,1027527,26196,5,132444,165
6087,CA,"Santa Cruz County, CA",142277,135530,6747,5,85770,107
6089,CA,"Shasta County, CA",74353,70878,3475,5,61464,76
6091,CA,"Sierra County, CA",1326,1255,71,7,55862,70
6093,CA,"Siskiyou County, CA",17227,16109,1118,4,45954,57
6095,CA,"Solano County, CA",209527,201672,7855,3,85704,107
6097,CA,"Sonoma County, CA",259394,252428,6966,6,87084,108
6099,CA,"Stanislaus County, CA",243454,228753,14701,7,62761,78
6101,CA,"Sutter County, CA",45785,42440,3345,6,60910,76
6103,CA,"Tehama County, CA",25650,24228,1422,6,51672,64
6105,CA,"Trinity County, CA",4693,4436,257,10,43881,55
6107,CA,"Tulare County, CA",203980,184353,19627,5,56776,71
6109,CA,"Tuolumne County, CA",21317,20366,951,4,64729,81
6111,CA,"Ventura County, CA",423390,408169,15221,4,91446,114
6113,CA,"Yolo County, CA",108658,104220,4438,6,70951,88
6115,CA,"Yuba County, CA",29997,28182,1815,3,56607,70
8001,CO,"Adams County, CO",275440,267375,8065,4,75341,98
8003,CO,"Alamosa County, CO",8726,8413,313,3,38213,50
8005,CO,"Arapahoe County, CO",368504,358574,9930,3,82364,107
8007,CO,"Archuleta County, CO",6937,6717,220,2,57604,75
8009,CO,"Baca County, CO",2175,2138,37,3,38945,51
8011,CO,"Bent County, CO",1919,1863,56,2,35764,46
8013,CO,"Boulder County, CO",196991,192351,4640,2,88341,115
8014,CO,"Broomfield County/city, CO",40520,39528,992,2,106892,139
8015,CO,"Chaffee County, CO",9871,9636,235,2,60331,78
8017,CO,"Cheyenne County, CO",1173,1154,19,3,52337,68
8019,CO,"Clear Creek County, CO",6110,5960,150,4,79900,104
8021,CO,"Conejos County, CO",4165,4013,152,4,40944,53
8023,CO,"Costilla County, CO",1888,1814,74,4,34731,45
8025,CO,"Crowley County, CO",1525,1460,65,3,38224,50
8027,CO,"Custer County, CO",2088,2025,63,3,57381,74
8029,CO,"Delta County, CO",14519,14035,484,3,51525,67
8031,CO,"Denver County/city, CO",421322,409974,11348,3,75456,98
8033,CO,"Dolores County, CO",1164,1129,35,2,50232,65
8035,CO,"Douglas County, CO",196248,191586,4662,2,123697,160
8037,CO,"Eagle County, CO",37073,36241,832,2,89268,116
8039,CO,"Elbert County, CO",15344,15009,335,3,101733,132
8041,CO,"El Paso County, CO",342735,331453,11282,5,72675,94
8043,CO,"Fremont County, CO",15251,14548,703,3,52239,68
8045,CO,"Garfield County, CO",32910,32021,889,2,73788,96
8047,CO,"Gilpin County, CO",3820,3732,88,2,74806,97
8049,CO,"Grand County, CO",9978,9765,213,2,71029,92
8051,CO,"Gunnison County, CO",11594,11346,248,4,60408,78
8053,CO,"Hinsdale County, CO",438,422,16,6,61391,80
8055,CO,"Huerfano County, CO",2542,2396,146,2,39955,52
8057,CO,"Jackson County, CO",1003,980,23,3,53577,70
8059,CO,"Jefferson County, CO",338722,330124,8598,2,89696,116
8061,CO,"Kiowa County, CO",965,950,15,2,46901,61
8063,CO,"Kit Carson County, CO",4365,4292,73,2,42951,56
8065,CO,"Lake County, CO",4994,4878,116,3,56850,74
8067,CO,"La Plata County, CO",32305,31495,810,2,77829,101
8069,CO,"Larimer County, CO",206483,201624,4859,4,75332,98
8071,CO,"Las Animas County, CO",6635,6377,258,2,43452,56
8073,CO,"Lincoln County, CO",2431,2375,56,2,43077,56
8075,CO,"Logan County, CO",11167,10904,263,3,58429,76
8077,CO,"Mesa County, CO",76614,73986,2628,2,60249,78
8079,CO,"Mineral County, CO",533,521,12,3,63015,82
8081,CO,"Moffat County, CO",7450,7195,255,4,63232,82
8083,CO,"Montezuma County, CO",13038,12486,552,3,52641,68
8085,CO,"Montrose County, CO",22010,21327,683,3,50707,66
8087,CO,"Morgan County, CO",16582,16146,436,4,57535,75
8089,CO,"Otero County, CO",8495,8150,345,3,43723,57
8091,CO,"Ouray County, CO",2454,2383,71,3,72836,95
8093,CO,"Park County, CO",11292,11010,282,2,77221,100
8095,CO,"Phillips County, CO",2631,2589,42,3,53432,69
8097,CO,"Pitkin County, CO",11395,11041,354,3,92820,120
8099,CO,"Prowers County, CO",6408,6240,168,4,47051,61
8101,CO,"Pueblo County, CO",76276,73147,3129,4,51075,66
8103,CO,"Rio Blanco County, CO",3019,2908,111,4,65960,86
8105,CO,"Rio Grande County, CO",5506,5280,226,2,48496,63
8107,CO,"Routt County, CO",16491,16132,359,4,87691,114
8109,CO,"Saguache County, CO",3606,3462,144,3,37004,48
8111,CO,"San Juan County, CO",570,553,17,3,50524,66
8113,CO,"San Miguel County, CO",5900,5737,163,2,77209,100
8115,CO,"Sedgwick County, CO",1231,1206,25,2,42808,56
8117,CO,"Summit County, CO",23179,22760,419,3,86570,112
8119,CO,"Teller County, CO",12821,12425,396,2,70599,92
8121,CO,"Washington County, CO",3000,2941,59,3,53263,69
8123,CO,"Weld County, CO",170001,165670,4331,2,78160,101
8125,CO,"Yuma County, CO",6224,6126,98,4,52841,69
9001,CT,"Fairfield County, CT",481023,463547,17476,4,96966,123
9003,CT,"Hartford County, CT",483303,464533,18770,4,75336,96
9005,CT,"Litchfield County, CT",105182,101543,3639,3,81015,103
9007,CT,"Middlesex County, CT",93696,90703,2993,4,81721,104
9009,CT,"New Haven County, CT",461613,443514,18099,4,69687,88
9011,CT,"New London County, CT",137386,132423,4963,3,75226,95
9013,CT,"Tolland County, CT",87047,84207,2840,4,90181,114
9015,CT,"Windham County, CT",64281,61697,2584,4,63309,80
10001,DE,"Kent County, DE",79411,76097,3314,4,58804,84
10003,DE,"New Castle County, DE",300148,289100,11048,4,76076,108
10005,DE,"Sussex County, DE",107706,103648,4058,6,64839,92
11001,DC,District of Columbia,409969,387482,22487,3,90395,100
12001,FL,"Alachua County, FL",139217,135112,4105,3,49880,84
12003,FL,"Baker County, FL",11852,11484,368,4,60454,102
12005,FL,"Bay County, FL",84235,80980,3255,3,58376,99
12007,FL,"Bradford County, FL",11062,10715,347,3,47509,80
12009,FL,"Brevard County, FL",284087,275025,9062,3,57582,97
12011,FL,"Broward County, FL",1040519,1008813,31706,4,61429,104
12013,FL,"Calhoun County, FL",4819,4622,197,4,41399,70
12015,FL,"Charlotte County, FL",71865,69239,2626,5,54756,93
12017,FL,"Citrus County, FL",47377,45096,2281,3,49762,84
12019,FL,"Clay County, FL",107718,104467,3251,3,75776,128
12021,FL,"Collier County, FL",180626,175040,5586,3,76415,129
12023,FL,"Columbia County, FL",29797,28831,966,4,47087,80
12027,FL,"DeSoto County, FL",14185,13686,499,4,41673,70
12029,FL,"Dixie County, FL",5828,5606,222,3,39793,67
12031,FL,"Duval County, FL",491946,475890,16056,3,58339,99
12033,FL,"Escambia County, FL",145919,141253,4666,4,52822,89
12035,FL,"Flagler County, FL",47030,45235,1795,4,62831,106
12037,FL,"Franklin County, FL",4650,4486,164,4,47504,80
12039,FL,"Gadsden County, FL",18833,18061,772,3,42975,73
12041,FL,"Gilchrist County, FL",7145,6900,245,4,46171,78
12043,FL,"Glades County, FL",5384,5173,211,5,45412,77
12045,FL,"Gulf County, FL",5772,5495,277,4,53228,90
12047,FL,"Hamilton County, FL",4340,4162,178,5,39241,66
12049,FL,"Hardee County, FL",8502,8074,428,6,41430,70
12051,FL,"Hendry County, FL",15587,14680,907,4,45107,76
12053,FL,"Hernando County, FL",71923,68906,3017,5,50705,86
12055,FL,"Highlands County, FL",36094,34452,1642,3,45723,77
12057,FL,"Hillsborough County, FL",750269,727117,23152,4,61133,103
12059,FL,"Holmes County, FL",6947,6701,246,4,38874,66
12061,FL,"Indian River County, FL",65457,62949,2508,4,61173,103
12063,FL,"Jackson County, FL",17145,16522,623,3,40543,69
12065,FL,"Jefferson County, FL",5623,5436,187,3,47192,80
12067,FL,"Lafayette County, FL",2855,2769,86,3,45480,77
12069,FL,"Lake County, FL",159027,153919,5108,3,57660,97
12071,FL,"Lee County, FL",348027,337116,10911,3,62364,105
12073,FL,"Leon County, FL",155493,150713,4780,4,55081,93
12075,FL,"Levy County, FL",16725,16104,621,4,41405,70
12077,FL,"Liberty County, FL",2639,2545,94,4,44236,75
12079,FL,"Madison County, FL",7469,7188,281,3,37919,64
12081,FL,"Manatee County, FL",179993,174382,5611,4,64151,108
12083,FL,"Marion County, FL",137624,132335,5289,3,49079,83
12085,FL,"Martin County, FL",74119,71786,2333,2,70806,120
12086,FL,"Miami-Dade County, FL",1383989,1350924,33065,2,54991,93
12087,FL,"Monroe County, FL",46755,45792,963,3,67528,114
12089,FL,"Nassau County, FL",41210,40000,1210,3,72818,123
12091,FL,"Okaloosa County, FL",96940,94342,2598,4,63520,107
12093,FL,"Okeechobee County, FL",17801,17184,617,3,45225,76
12095,FL,"Orange County, FL",762737,740564,22173,3,63133,107
12097,FL,"Osceola County, FL",184329,178283,6046,3,52270,88
12099,FL,"Palm Beach County, FL",733663,709694,23969,4,66621,113
12101,FL,"Pasco County, FL",237941,229631,8310,3,55745,94
12103,FL,"Pinellas County, FL",494185,479472,14713,4,56708,96
12105,FL,"Polk County, FL",305752,294472,11280,4,51817,88
12107,FL,"Putnam County, FL",26563,25413,1150,3,41986,71
12109,FL,"St. Johns County, FL",132464,128970,3494,4,90839,153
12111,FL,"St. Lucie County, FL",145111,139389,5722,3,57292,97
12113,FL,"Santa Rosa County, FL",82903,80448,2455,3,66139,112
12115,FL,"Sarasota County, FL",189137,183288,5849,3,66258,112
12117,FL,"Seminole County, FL",255529,248085,7444,5,69954,118
12119,FL,"Sumter County, FL",32628,31126,1502,3,63464,107
12121,FL,"Suwannee County, FL",18046,17427,619,4,49453,84
12123,FL,"Taylor County, FL",8229,7934,295,3,42987,73
12125,FL,"Union County, FL",4638,4501,137,3,50893,86
12127,FL,"Volusia County, FL",254312,245545,8767,3,53554,91
12129,FL,"Wakulla County, FL",14921,14487,434,3,58640,99
12131,FL,"Walton County, FL",31577,30685,892,3,62600,106
12133,FL,"Washington County, FL",9678,9348,330,3,42518,72
13001,GA,"Appling County, GA",9306,8945,361,3,43821,71
13003,GA,"Atkinson County, GA",4695,4552,143,4,38581,62
13005,GA,"Bacon County, GA",4966,4790,176,5,41807,68
13007,GA,"Baker County, GA",1163,1108,55,4,39515,64
13009,GA,"Baldwin County, GA",17409,16671,738,3,44429,72
13011,GA,"Banks County, GA",9616,9352,264,3,53481,86
13013,GA,"Barrow County, GA",40385,39247,1138,3,68924,111
13015,GA,"Bartow County, GA",50539,48885,1654,6,60254,97
13017,GA,"Ben Hill County, GA",5348,5053,295,4,35931,58
13019,GA,"Berrien County, GA",7474,7176,298,4,42058,68
13021,GA,"Bibb County, GA",67896,65249,2647,5,43066,70
13023,GA,"Bleckley County, GA",4531,4303,228,4,48115,78
13025,GA,"Brantley County, GA",7258,6964,294,3,44680,72
13027,GA,"Brooks County, GA",6901,6668,233,3,39554,64
13029,GA,"Bryan County, GA",18286,17738,548,4,79296,128
13031,GA,"Bulloch County, GA",36540,35170,1370,5,48788,79
13033,GA,"Burke County, GA",9154,8689,465,3,42632,69
13035,GA,"Butts County, GA",10737,10377,360,4,47410,77
13037,GA,"Calhoun County, GA",2233,2152,81,4,34960,56
13039,GA,"Camden County, GA",20869,20113,756,3,58552,95
13043,GA,"Candler County, GA",5548,5383,165,3,41665,67
13045,GA,"Carroll County, GA",55210,53325,1885,3,59193,96
13047,GA,"Catoosa County, GA",33517,32518,999,4,60753,98
13049,GA,"Charlton County, GA",4785,4604,181,3,42891,69
13051,GA,"Chatham County, GA",139657,135052,4605,5,57122,92
13053,GA,"Chattahoochee County, GA",1997,1906,91,5,46106,74
13055,GA,"Chattooga County, GA",10307,9795,512,3,41561,67
13057,GA,"Cherokee County, GA",135814,132118,3696,4,88635,143
13059,GA,"Clarke County, GA",59096,56997,2099,7,41036,66
13061,GA,"Clay County, GA",880,819,61,4,24732,40
13063,GA,"Clayton County, GA",137796,131980,5816,4,50737,82
13065,GA,"Clinch County, GA",2654,2550,104,3,42928,69
13067,GA,"Cobb County, GA",425167,412592,12575,4,79622,129
13069,GA,"Coffee County, GA",18869,18138,731,3,41675,67
13071,GA,"Colquitt County, GA",21377,20702,675,3,41899,68
13073,GA,"Columbia County, GA",75134,72860,2274,3,88285,143
13075,GA,"Cook County, GA",7988,7718,270,3,40670,66
13077,GA,"Coweta County, GA",74594,72410,2184,4,79232,128
13079,GA,"Crawford County, GA",5605,5404,201,4,50411,81
13081,GA,"Crisp County, GA",9433,9065,368,3,40482,65
13083,GA,"Dade County, GA",8209,7941,268,3,45986,74
13085,GA,"Dawson County, GA",12320,11971,349,4,69155,112
13087,GA,"Decatur County, GA",11540,11101,439,3,40473,65
13089,GA,"DeKalb County, GA",399354,385700,13654,5,63606,103
13091,GA,"Dodge County, GA",7081,6700,381,4,41118,66
13093,GA,"Dooly County, GA",5071,4880,191,5,37109,60
13095,GA,"Dougherty County, GA",38327,36509,1818,4,36894,60
13097,GA,"Douglas County, GA",73217,70640,2577,4,62915,102
13099,GA,"Early County, GA",4372,4201,171,3,40011,65
13101,GA,"Echols County, GA",1909,1856,53,3,40408,65
13103,GA,"Effingham County, GA",30889,30000,889,4,71628,116
13105,GA,"Elbert County, GA",7658,7352,306,5,40962,66
13107,GA,"Emanuel County, GA",8287,7847,440,3,38529,62
13109,GA,"Evans County, GA",4862,4698,164,3,41425,67
13111,GA,"Fannin County, GA",11512,11132,380,3,47980,77
13113,GA,"Fayette County, GA",57985,56256,1729,4,94563,153
13115,GA,"Floyd County, GA",44144,42455,1689,3,50520,82
13117,GA,"Forsyth County, GA",122076,118737,3339,4,113332,183
13119,GA,"Franklin County, GA",9942,9592,350,4,47691,77
13121,GA,"Fulton County, GA",556954,537605,19349,4,79235,128
13123,GA,"Gilmer County, GA",11861,11444,417,4,57007,92
13125,GA,"Glascock County, GA",1272,1225,47,3,49350,80
13127,GA,"Glynn County, GA",39345,38039,1306,3,58017,94
13129,GA,"Gordon County, GA",27976,27025,951,3,53373,86
13131,GA,"Grady County, GA",10449,10093,356,4,42603,69
13133,GA,"Greene County, GA",7010,6740,270,3,60973,98
13135,GA,"Gwinnett County, GA",489610,474882,14728,4,72225,117
13137,GA,"Habersham County, GA",19069,18411,658,3,51296,83
13139,GA,"Hall County, GA",102061,99222,2839,6,66698,108
13141,GA,"Hancock County, GA",2447,2312,135,3,31715,51
13143,GA,"Haralson County, GA",12557,12141,416,3,49020,79
13145,GA,"Harris County, GA",16649,16139,510,4,74052,120
13147,GA,"Hart County, GA",11303,10903,400,3,50647,82
13149,GA,"Heard County, GA",5248,5073,175,4,48984,79
13151,GA,"Henry County, GA",115495,111409,4086,3,72927,118
13153,GA,"Houston County, GA",70345,68005,2340,5,65641,106
13155,GA,"Irwin County, GA",3328,3172,156,3,42317,68
13157,GA,"Jackson County, GA",36518,35550,968,3,66645,108
13159,GA,"Jasper County, GA",6939,6726,213,5,59207,96
13161,GA,"Jeff Davis County, GA",6051,5772,279,5,40603,66
13163,GA,"Jefferson County, GA",6572,6260,312,5,35379,57
13165,GA,"Jenkins County, GA",3143,2983,160,4,32808,53
13167,GA,"Johnson County, GA",4036,3889,147,3,37771,61
13169,GA,"Jones County, GA",13696,13262,434,4,56819,92
13171,GA,"Lamar County, GA",8232,7914,318,4,57402,93
13173,GA,"Lanier County, GA",3748,3601,147,5,42667,69
13175,GA,"Laurens County, GA",19142,18269,873,3,42018,68
13177,GA,"Lee County, GA",14717,14268,449,4,72425,117
13179,GA,"Liberty County, GA",26096,25119,977,4,51410,83
13181,GA,"Lincoln County, GA",3554,3417,137,4,45299,73
13183,GA,"Long County, GA",8137,7841,296,4,52051,84
13185,GA,"Lowndes County, GA",51180,49376,1804,3,46450,75
13187,GA,"Lumpkin County, GA",16719,16200,519,5,57078,92
13189,GA,"McDuffie County, GA",8852,8402,450,4,44473,72
13191,GA,"McIntosh County, GA",6167,5948,219,5,46682,75
13193,GA,"Macon County, GA",4693,4476,217,3,34634,56
13195,GA,"Madison County, GA",13282,12877,405,4,52326,85
13197,GA,"Marion County, GA",3305,3165,140,5,41190,67
13199,GA,"Meriwether County, GA",8911,8510,401,3,43571,70
13201,GA,"Miller County, GA",2749,2659,90,5,41769,67
13205,GA,"Mitchell County, GA",8445,8060,385,3,37383,60
13207,GA,"Monroe County, GA",12995,12574,421,5,70488,114
13209,GA,"Montgomery County, GA",3807,3607,200,3,43657,71
13211,GA,"Morgan County, GA",9240,8953,287,5,67089,108
13213,GA,"Murray County, GA",15505,14725,780,5,50061,81
13215,GA,"Muscogee County, GA",77490,73977,3513,4,47035,76
13217,GA,"Newton County, GA",52197,50187,2010,3,58222,94
13219,GA,"Oconee County, GA",19510,19014,496,3,100878,163
13221,GA,"Oglethorpe County, GA",6929,6706,223,3,54346,88
13223,GA,"Paulding County, GA",85916,83397,2519,4,76580,124
13225,GA,"Peach County, GA",11826,11343,483,3,49815,80
13227,GA,"Pickens County, GA",15271,14816,455,3,66183,107
13229,GA,"Pierce County, GA",8698,8404,294,3,46701,75
13231,GA,"Pike County, GA",8899,8631,268,4,74905,121
13233,GA,"Polk County, GA",18429,17761,668,4,47896,77
13235,GA,"Pulaski County, GA",4052,3896,156,4,42274,68
13237,GA,"Putnam County, GA",8185,7831,354,5,62282,101
13239,GA,"Quitman County, GA",800,760,40,4,35522,57
13241,GA,"Rabun County, GA",7152,6900,252,5,46639,75
13243,GA,"Randolph County, GA",2527,2405,122,5,33505,54
13245,GA,"Richmond County, GA",85085,81242,3843,4,44810,72
13247,GA,"Rockdale County, GA",44751,43061,1690,4,60281,97
13249,GA,"Schley County, GA",2200,2115,85,5,51129,83
13251,GA,"Screven County, GA",5088,4813,275,4,42331,68
13253,GA,"Seminole County, GA",3037,2903,134,4,38618,62
13255,GA,"Spalding County, GA",28675,27530,1145,4,49237,80
13257,GA,"Stephens County, GA",10685,10273,412,4,45416,73
13259,GA,"Stewart County, GA",2396,2296,100,5,34566,56
13261,GA,"Sumter County, GA",12686,12077,609,5,40250,65
13263,GA,"Talbot County, GA",2819,2693,126,5,41045,66
13265,GA,"Taliaferro County, GA",567,539,28,4,37046,60
13267,GA,"Tattnall County, GA",9560,9194,366,4,41457,67
13269,GA,"Taylor County, GA",3074,2950,124,10,28234,46
13271,GA,"Telfair County, GA",4107,3716,391,5,36264,59
13273,GA,"Terrell County, GA",3510,3333,177,4,37122,60
13275,GA,"Thomas County, GA",16470,15807,663,3,47978,77
13277,GA,"Tift County, GA",19751,19088,663,5,47764,77
13279,GA,"Toombs County, GA",11655,11079,576,5,41442,67
13281,GA,"Towns County, GA",3893,3705,188,5,49023,79
13283,GA,"Treutlen County, GA",2642,2503,139,3,37478,61
13285,GA,"Troup County, GA",37304,36117,1187,4,47296,76
13287,GA,"Turner County, GA",3139,3019,120,5,35400,57
13289,GA,"Twiggs County, GA",2878,2722,156,3,44079,71
13291,GA,"Union County, GA",10274,9953,321,4,57049,92
13293,GA,"Upson County, GA",11320,10916,404,4,40926,66
13295,GA,"Walker County, GA",31358,30242,1116,3,47548,77
13297,GA,"Walton County, GA",46011,44601,1410,4,67007,108
13299,GA,"Ware County, GA",15555,14986,569,5,37642,61
13301,GA,"Warren County, GA",2821,2693,128,4,37313,60
13303,GA,"Washington County, GA",7013,6722,291,4,41674,67
13305,GA,"Wayne County, GA",11403,10947,456,5,47382,77
13307,GA,"Webster County, GA",1007,957,50,8,41547,67
13309,GA,"Wheeler County, GA",1610,1490,120,3,35927,58
13311,GA,"White County, GA",16266,15836,430,4,54786,88
13313,GA,"Whitfield County, GA",43564,41637,1927,5,53115,86
13315,GA,"Wilcox County, GA",2695,2575,120,5,38261,62
13317,GA,"Wilkes County, GA",3823,3650,173,4,39716,64
13319,GA,"Wilkinson County, GA",3959,3808,151,4,43902,71
13321,GA,"Worth County, GA",8897,8552,345,3,43142,70
15001,HI,"Hawaii County, HI",91161,88018,3143,3,64929,78
15003,HI,"Honolulu County/city, HI",450562,438936,11626,3,86946,104
15007,HI,"Kauai County, HI",36536,35558,978,3,73029,87
15009,HI,"Maui County, HI",86733,84461,2272,3,77375,92
16001,ID,"Ada County, ID",254224,247855,6369,7,72295,119
16003,ID,"Adams County, ID",1721,1604,117,3,50042,82
16005,ID,"Bannock County, ID",42752,41546,1206,3,53306,88
16007,ID,"Bear Lake County, ID",2978,2891,87,5,54550,90
16009,ID,"Benewah County, ID",4109,3894,215,3,49303,81
16011,ID,"Bingham County, ID",23817,23182,635,3,59959,99
16013,ID,"Blaine County, ID",12318,11995,323,4,75778,125
16015,ID,"Boise County, ID",3516,3365,151,4,64443,106
16017,ID,"Bonner County, ID",20058,19222,836,2,56729,93
16019,ID,"Bonneville County, ID",57042,55678,1364,4,65165,107
16021,ID,"Boundary County, ID",5376,5138,238,3,50709,83
16023,ID,"Butte County, ID",1397,1360,37,3,51742,85
16025,ID,"Camas County, ID",695,676,19,3,56014,92
16027,ID,"Canyon County, ID",104402,101058,3344,3,58670,96
16029,ID,"Caribou County, ID",4135,4025,110,2,61518,101
16031,ID,"Cassia County, ID",12215,11920,295,4,53284,88
16033,ID,"Clark County, ID",378,364,14,7,48726,80
16035,ID,"Clearwater County, ID",2905,2708,197,4,49816,82
16037,ID,"Custer County, ID",2228,2134,94,3,49055,81
16039,ID,"Elmore County, ID",11547,11169,378,2,47796,79
16041,ID,"Franklin County, ID",7041,6876,165,2,55421,91
16043,ID,"Fremont County, ID",7870,7686,184,3,56162,92
16045,ID,"Gem County, ID",8308,8035,273,3,53733,88
16047,ID,"Gooding County, ID",8222,8005,217,5,50205,83
16049,ID,"Idaho County, ID",6563,6265,298,2,48866,80
16051,ID,"Jefferson County, ID",14035,13709,326,3,63078,104
16053,ID,"Jerome County, ID",12199,11884,315,4,56320,93
16055,ID,"Kootenai County, ID",80102,77257,2845,3,62764,103
16057,ID,"Latah County, ID",20549,19994,555,5,54999,90
16059,ID,"Lemhi County, ID",3566,3396,170,6,46062,76
16061,ID,"Lewis County, ID",1648,1558,90,4,45342,75
16063,ID,"Lincoln County, ID",2703,2607,96,2,50608,83
16065,ID,"Madison County, ID",21941,21539,402,3,46177,76
16067,ID,"Minidoka County, ID",11442,11151,291,3,56173,92
16069,ID,"Nez Perce County, ID",21057,20459,598,2,67645,111
16071,ID,"Oneida County, ID",2321,2268,53,3,55833,92
16073,ID,"Owyhee County, ID",5434,5251,183,4,48395,80
16075,ID,"Payette County, ID",11663,11248,415,3,53643,88
16077,ID,"Power County, ID",4092,3965,127,6,50981,84
16079,ID,"Shoshone County, ID",5143,4839,304,2,39239,65
16081,ID,"Teton County, ID",6626,6480,146,3,73637,121
16083,ID,"Twin Falls County, ID",41393,40234,1159,4,56141,92
16085,ID,"Valley County, ID",5554,5338,216,4,64041,105
16087,ID,"Washington County, ID",4612,4420,192,4,45813,75
17001,IL,"Adams County, IL",32358,31249,1109,6,55942,81
17003,IL,"Alexander County, IL",2050,1923,127,4,37408,54
17005,IL,"Bond County, IL",7833,7533,300,6,53447,77
17007,IL,"Boone County, IL",26377,24890,1487,2,72426,105
17009,IL,"Brown County, IL",2993,2921,72,5,60254,87
17011,IL,"Bureau County, IL",17392,16585,807,5,57935,84
17013,IL,"Calhoun County, IL",2338,2225,113,4,63373,92
17015,IL,"Carroll County, IL",7325,7022,303,4,56468,82
17017,IL,"Cass County, IL",6131,5878,253,4,51011,74
17019,IL,"Champaign County, IL",109116,105014,4102,5,53485,77
17021,IL,"Christian County, IL",14615,13910,705,5,51573,75
17023,IL,"Clark County, IL",7693,7345,348,5,58323,84
17025,IL,"Clay County, IL",6508,6212,296,3,49377,71
17027,IL,"Clinton County, IL",20548,19908,640,4,67201,97
17029,IL,"Coles County, IL",23855,22889,966,4,50467,73
17031,IL,"Cook County, IL",2594759,2496526,98233,4,69375,100
17033,IL,"Crawford County, IL",8715,8340,375,3,50352,73
17035,IL,"Cumberland County, IL",6125,5915,210,4,53991,78
17037,IL,"DeKalb County, IL",55397,53115,2282,4,64676,93
17039,IL,"De Witt County, IL",7490,7165,325,4,59521,86
17041,IL,"Douglas County, IL",10263,9897,366,3,64283,93
17043,IL,"DuPage County, IL",507802,492985,14817,4,96354,139
17045,IL,"Edgar County, IL",9019,8636,383,4,51333,74
17047,IL,"Edwards County, IL",2715,2604,111,3,54930,79
17049,IL,"Effingham County, IL",19370,18740,630,4,58943,85
17051,IL,"Fayette County, IL",9940,9504,436,4,48913,71
17053,IL,"Ford County, IL",6490,6211,279,5,55369,80
17055,IL,"Franklin County, IL",16456,15565,891,6,43695,63
17057,IL,"Fulton County, IL",15262,14409,853,5,50461,73
17059,IL,"Gallatin County, IL",2359,2244,115,4,46515,67
17061,IL,"Greene County, IL",6036,5776,260,5,52116,75
17063,IL,"Grundy County, IL",25443,24307,1136,4,83135,120
17065,IL,"Hamilton County, IL",4449,4277,172,5,51031,74
17067,IL,"Hancock County, IL",8464,8067,397,7,53724,78
17069,IL,"Hardin County, IL",1318,1231,87,5,44573,64
17071,IL,"Henderson County, IL",3638,3463,175,5,55535,80
17073,IL,"Henry County, IL",25217,24015,1202,4,61680,89
17075,IL,"Iroquois County, IL",14481,13873,608,4,51542,75
17077,IL,"Jackson County, IL",28083,27012,1071,4,37308,54
17079,IL,"Jasper County, IL",4667,4469,198,5,59980,87
17081,IL,"Jefferson County, IL",17525,16720,805,4,50531,73
17083,IL,"Jersey County, IL",11044,10555,489,4,63351,92
17085,IL,"Jo Daviess County, IL",10869,10428,441,6,62522,90
17087,IL,"Johnson County, IL",4155,3905,250,4,55022,80
17089,IL,"Kane County, IL",274298,262136,12162,5,84311,122
17091,IL,"Kankakee County, IL",56207,53396,2811,3,60763,88
17093,IL,"Kendall County, IL",68630,66358,2272,5,105586,153
17095,IL,"Knox County, IL",21856,20771,1085,4,43404,63
17097,IL,"Lake County, IL",378425,362822,15603,5,92638,134
17099,IL,"LaSalle County, IL",55002,52081,2921,5,59528,86
17101,IL,"Lawrence County, IL",5913,5606,307,4,47114,68
17103,IL,"Lee County, IL",17724,17018,706,4,57619,83
17105,IL,"Livingston County, IL",16663,15984,679,4,54422,79
17107,IL,"Logan County, IL",12739,12185,554,5,53806,78
17109,IL,"McDonough County, IL",13458,12830,628,3,49048,71
17111,IL,"McHenry County, IL",165574,160086,5488,4,89379,129
17113,IL,"McLean County, IL",88460,85134,3326,5,69230,100
17115,IL,"Macon County, IL",48905,46328,2577,4,52259,76
17117,IL,"Macoupin County, IL",23125,22136,989,4,54174,78
17119,IL,"Madison County, IL",134999,129708,5291,5,66591,96
17121,IL,"Marion County, IL",17680,16889,791,5,52291,76
17123,IL,"Marshall County, IL",5366,5108,258,5,63628,92
17125,IL,"Mason County, IL",6342,6004,338,6,51967,75
17127,IL,"Massac County, IL",5652,5336,316,4,54159,78
17129,IL,"Menard County, IL",6542,6295,247,5,77306,112
17131,IL,"Mercer County, IL",8168,7761,407,3,62241,90
17133,IL,"Monroe County, IL",18902,18313,589,5,90904,131
17135,IL,"Montgomery County, IL",11823,11207,616,4,51665,75
17137,IL,"Morgan County, IL",16578,15910,668,3,55937,81
17139,IL,"Moultrie County, IL",7638,7384,254,5,65472,95
17141,IL,"Ogle County, IL",25162,23947,1215,5,63565,92
17143,IL,"Peoria County, IL",85453,81085,4368,5,57717,83
17145,IL,"Perry County, IL",8391,7960,431,4,56880,82
17147,IL,"Piatt County, IL",8632,8319,313,4,72265,104
17149,IL,"Pike County, IL",7057,6751,306,6,54309,79
17151,IL,"Pope County, IL",1693,1599,94,7,46478,67
17153,IL,"Pulaski County, IL",1996,1865,131,5,38506,56
17155,IL,"Putnam County, IL",3066,2912,154,4,74367,107
17157,IL,"Randolph County, IL",14371,13842,529,4,58444,84
17159,IL,"Richland County, IL",7273,6975,298,5,49775,72
17161,IL,"Rock Island County, IL",71937,68377,3560,5,57772,84
17163,IL,"St. Clair County, IL",127362,121685,5677,5,57726,83
17165,IL,"Saline County, IL",9702,9188,514,4,48547,70
17167,IL,"Sangamon County, IL",101644,97552,4092,4,61768,89
17169,IL,"Schuyler County, IL",3277,3139,138,5,56015,81
17171,IL,"Scott County, IL",2530,2410,120,4,61231,89
17173,IL,"Shelby County, IL",10695,10278,417,6,61376,89
17175,IL,"Stark County, IL",2555,2409,146,4,54804,79
17177,IL,"Stephenson County, IL",21823,20868,955,4,51786,75
17179,IL,"Tazewell County, IL",64182,61347,2835,6,66206,96
17181,IL,"Union County, IL",7494,7070,424,5,51575,75
17183,IL,"Vermilion County, IL",33251,31540,1711,4,46295,67
17185,IL,"Wabash County, IL",5874,5648,226,4,54249,78
17187,IL,"Warren County, IL",8556,8207,349,3,53621,78
17189,IL,"Washington County, IL",10254,9995,259,5,64297,93
17191,IL,"Wayne County, IL",7031,6696,335,4,51829,75
17193,IL,"White County, IL",6663,6409,254,4,51388,74
17195,IL,"Whiteside County, IL",28849,27619,1230,4,50880,74
17197,IL,"Will County, IL",357236,343602,13634,4,90249,130
17199,IL,"Williamson County, IL",32146,30765,1381,6,56958,82
17201,IL,"Winnebago County, IL",140238,132290,7948,4,59510,86
17203,IL,"Woodford County, IL",18870,18165,705,3,77117,111
18001,IN,"Adams County, IN",17255,16785,470,3,53532,93
18003,IN,"Allen County, IN",186799,180923,5876,3,56838,99
18005,IN,"Bartholomew County, IN",45027,43902,1125,3,71181,124
18007,IN,"Benton County, IN",4582,4436,146,4,55016,96
18009,IN,"Blackford County, IN",5006,4808,198,3,46811,81
18011,IN,"Boone County, IN",36450,35553,897,3,84137,146
18013,IN,"Brown County, IN",7750,7518,232,3,59617,104
18015,IN,"Carroll County, IN",10276,9967,309,4,58965,102
18017,IN,"Cass County, IN",17995,17366,629,3,51777,90
18019,IN,"Clark County, IN",61893,59835,2058,4,59441,103
18021,IN,"Clay County, IN",12124,11694,430,3,54349,94
18023,IN,"Clinton County, IN",17231,16769,462,4,55336,96
18025,IN,"Crawford County, IN",4874,4672,202,3,44332,77
18027,IN,"Daviess County, IN",16772,16337,435,4,56611,98
18029,IN,"Dearborn County, IN",25931,25010,921,3,71351,124
18031,IN,"Decatur County, IN",15052,14618,434,3,60891,106
18033,IN,"DeKalb County, IN",22758,22116,642,4,59714,104
18035,IN,"Delaware County, IN",53945,51853,2092,2,45912,80
18037,IN,"Dubois County, IN",23145,22590,555,3,63869,111
18039,IN,"Elkhart County, IN",112941,109468,3473,5,55782,97
18041,IN,"Fayette County, IN",8791,8375,416,3,48499,84
18043,IN,"Floyd County, IN",41797,40476,1321,4,64614,112
18045,IN,"Fountain County, IN",8060,7777,283,3,55337,96
18047,IN,"Franklin County, IN",11446,11052,394,3,67315,117
18049,IN,"Fulton County, IN",9916,9601,315,3,55011,96
18051,IN,"Gibson County, IN",19534,19043,491,4,61872,107
18053,IN,"Grant County, IN",31833,30648,1185,4,47509,83
18055,IN,"Greene County, IN",13728,13164,564,3,51918,90
18057,IN,"Hamilton County, IN",184661,180004,4657,3,107710,187
18059,IN,"Hancock County, IN",40470,39317,1153,3,77905,135
18061,IN,"Harrison County, IN",20386,19727,659,3,64270,112
18063,IN,"Hendricks County, IN",90412,87966,2446,3,85827,149
18065,IN,"Henry County, IN",22165,21435,730,4,49293,86
18067,IN,"Howard County, IN",36915,35432,1483,3,54048,94
18069,IN,"Huntington County, IN",18344,17745,599,3,54565,95
18071,IN,"Jackson County, IN",22962,22356,606,4,59472,103
18073,IN,"Jasper County, IN",16435,15831,604,3,65352,113
18075,IN,"Jay County, IN",9503,9216,287,3,49447,86
18077,IN,"Jefferson County, IN",15078,14567,511,3,53378,93
18079,IN,"Jennings County, IN",13599,13151,448,3,55022,96
18081,IN,"Johnson County, IN",83375,81134,2241,3,74427,129
18083,IN,"Knox County, IN",18584,18011,573,3,48760,85
18085,IN,"Kosciusko County, IN",42438,41248,1190,3,64677,112
18087,IN,"LaGrange County, IN",20073,19514,559,5,70746,123
18089,IN,"Lake County, IN",232451,221096,11355,4,57280,99
18091,IN,"LaPorte County, IN",48062,46012,2050,4,56427,98
18093,IN,"Lawrence County, IN",21247,20481,766,4,56261,98
18095,IN,"Madison County, IN",59452,57262,2190,3,54145,94
18097,IN,"Marion County, IN",492967,476851,16116,3,50707,88
18099,IN,"Marshall County, IN",23239,22513,726,3,53695,93
18101,IN,"Martin County, IN",5380,5239,141,4,56735,99
18103,IN,"Miami County, IN",15517,14911,606,3,53658,93
18105,IN,"Monroe County, IN",70338,68000,2338,3,53113,92
18107,IN,"Montgomery County, IN",18852,18275,577,3,54366,94
18109,IN,"Morgan County, IN",36532,35404,1128,4,63414,110
18111,IN,"Newton County, IN",7035,6746,289,3,61457,107
18113,IN,"Noble County, IN",23760,23023,737,4,60980,106
18115,IN,"Ohio County, IN",3201,3089,112,4,58294,101
18117,IN,"Orange County, IN",8653,8353,300,4,47931,83
18119,IN,"Owen County, IN",9413,9038,375,4,53387,93
18121,IN,"Parke County, IN",7116,6847,269,3,51554,90
18123,IN,"Perry County, IN",9306,8998,308,3,53908,94
18125,IN,"Pike County, IN",6151,5948,203,4,52378,91
18127,IN,"Porter County, IN",87566,84303,3263,3,74064,129
18129,IN,"Posey County, IN",13680,13306,374,3,68435,119
18131,IN,"Pulaski County, IN",6569,6367,202,4,52432,91
18133,IN,"Putnam County, IN",16868,16286,582,4,64098,111
18135,IN,"Randolph County, IN",11347,10922,425,3,50496,88
18137,IN,"Ripley County, IN",14326,13860,466,3,61219,106
18139,IN,"Rush County, IN",9004,8763,241,4,54371,94
18141,IN,"St. Joseph County, IN",136431,131498,4933,4,53881,94
18143,IN,"Scott County, IN",10600,10221,379,3,50571,88
18145,IN,"Shelby County, IN",23275,22600,675,3,59798,104
18147,IN,"Spencer County, IN",10841,10501,340,4,59183,103
18149,IN,"Starke County, IN",9963,9531,432,3,54001,94
18151,IN,"Steuben County, IN",20785,20232,553,4,59444,103
18153,IN,"Sullivan County, IN",8444,8085,359,3,53375,93
18155,IN,"Switzerland County, IN",5024,4857,167,3,52482,91
18157,IN,"Tippecanoe County, IN",99148,96245,2903,3,51228,89
18159,IN,"Tipton County, IN",9337,9084,253,3,69960,121
18161,IN,"Union County, IN",3574,3457,117,3,53866,94
18163,IN,"Vanderburgh County, IN",94928,92022,2906,5,51603,90
18165,IN,"Vermillion County, IN",7041,6675,366,4,50723,88
18167,IN,"Vigo County, IN",48492,46409,2083,3,48082,84
18169,IN,"Wabash County, IN",15101,14630,471,3,59874,104
18171,IN,"Warren County, IN",4225,4098,127,3,64109,111
18173,IN,"Warrick County, IN",33195,32233,962,3,79644,138
18175,IN,"Washington County, IN",13771,13315,456,4,51948,90
18177,IN,"Wayne County, IN",30881,29776,1105,3,47885,83
18179,IN,"Wells County, IN",14514,14123,391,3,61636,107
18181,IN,"White County, IN",13577,13210,367,3,58295,101
18183,IN,"Whitley County, IN",17881,17354,527,3,67347,117
19001,IA,"Adair County, IA",4281,4180,101,2,57977,94
19003,IA,"Adams County, IA",2209,2171,38,4,53385,86
19005,IA,"Allamakee County, IA",7490,7227,263,4,56240,91
19007,IA,"Appanoose County, IA",6044,5829,215,3,41672,67
19009,IA,"Audubon County, IA",3172,3093,79,3,53197,86
19011,IA,"Benton County, IA",13745,13339,406,3,70023,113
19013,IA,"Black Hawk County, IA",70280,68011,2269,2,60010,97
19015,IA,"Boone County, IA",15151,14791,360,2,63975,104
19017,IA,"Bremer County, IA",14103,13774,329,3,67229,109
19019,IA,"Buchanan County, IA",11481,11163,318,2,67906,110
19021,IA,"Buena Vista County, IA",11924,11673,251,3,57048,92
19023,IA,"Butler County, IA",8015,7758,257,3,57080,92
19025,IA,"Calhoun County, IA",4312,4202,110,2,57007,92
19027,IA,"Carroll County, IA",11106,10890,216,3,61379,99
19029,IA,"Cass County, IA",6998,6800,198,3,53692,87
19031,IA,"Cedar County, IA",11010,10738,272,3,71029,115
19033,IA,"Cerro Gordo County, IA",23919,23262,657,3,54589,88
19035,IA,"Cherokee County, IA",6243,6086,157,3,59901,97
19037,IA,"Chickasaw County, IA",6605,6416,189,3,60111,97
19039,IA,"Clarke County, IA",4943,4799,144,3,57708,93
19041,IA,"Clay County, IA",8624,8385,239,4,57174,93
19043,IA,"Clayton County, IA",10301,9925,376,4,53223,86
19045,IA,"Clinton County, IA",23154,22291,863,4,56865,92
19047,IA,"Crawford County, IA",8266,7971,295,2,58077,94
19049,IA,"Dallas County, IA",50365,49377,988,3,97535,158
19051,IA,"Davis County, IA",4263,4141,122,2,57150,93
19053,IA,"Decatur County, IA",4453,4354,99,2,44873,73
19055,IA,"Delaware County, IA",10720,10468,252,4,70091,113
19057,IA,"Des Moines County, IA",19587,18810,777,3,53547,87
19059,IA,"Dickinson County, IA",10228,9933,295,3,66211,107
19061,IA,"Dubuque County, IA",56937,55435,1502,3,62481,101
19063,IA,"Emmet County, IA",5332,5196,136,4,55635,90
19065,IA,"Fayette County, IA",10750,10367,383,4,53142,86
19067,IA,"Floyd County, IA",8977,8657,320,2,55369,90
19069,IA,"Franklin County, IA",5795,5659,136,3,55847,90
19071,IA,"Fremont County, IA",3732,3629,103,2,60498,98
19073,IA,"Greene County, IA",5499,5367,132,3,55562,90
19075,IA,"Grundy County, IA",6623,6440,183,3,73683,119
19077,IA,"Guthrie County, IA",5703,5533,170,3,64965,105
19079,IA,"Hamilton County, IA",7014,6814,200,2,63234,102
19081,IA,"Hancock County, IA",5995,5850,145,3,62030,100
19083,IA,"Hardin County, IA",8201,7939,262,2,57103,92
19085,IA,"Harrison County, IA",7480,7297,183,3,63901,103
19087,IA,"Henry County, IA",9932,9668,264,3,57747,93
19089,IA,"Howard County, IA",5256,5108,148,3,58028,94
19091,IA,"Humboldt County, IA",5190,5052,138,2,56695,92
19093,IA,"Ida County, IA",4190,4107,83,2,58249,94
19095,IA,"Iowa County, IA",10686,10450,236,3,66861,108
19097,IA,"Jackson County, IA",11166,10814,352,3,57687,93
19099,IA,"Jasper County, IA",20067,19478,589,2,67317,109
19101,IA,"Jefferson County, IA",10253,10002,251,2,51741,84
19103,IA,"Johnson County, IA",87724,85941,1783,3,67295,109
19105,IA,"Jones County, IA",10876,10532,344,3,63399,103
19107,IA,"Keokuk County, IA",5309,5136,173,2,54937,89
19109,IA,"Kossuth County, IA",8537,8347,190,4,59568,96
19111,IA,"Lee County, IA",16350,15706,644,3,51089,83
19113,IA,"Linn County, IA",124290,120668,3622,3,64783,105
19115,IA,"Louisa County, IA",6135,5947,188,2,60544,98
19117,IA,"Lucas County, IA",4700,4603,97,2,53085,86
19119,IA,"Lyon County, IA",7165,7047,118,4,66139,107
19121,IA,"Madison County, IA",8722,8404,318,3,72578,117
19123,IA,"Mahaska County, IA",12034,11729,305,2,59242,96
19125,IA,"Marion County, IA",18614,18215,399,5,66381,107
19127,IA,"Marshall County, IA",18204,17381,823,2,55631,90
19129,IA,"Mills County, IA",7509,7334,175,2,72679,118
19131,IA,"Mitchell County, IA",6952,6834,118,3,61247,99
19133,IA,"Monona County, IA",4509,4375,134,3,53104,86
19135,IA,"Monroe County, IA",4080,3955,125,3,56397,91
19137,IA,"Montgomery County, IA",5077,4942,135,3,52715,85
19139,IA,"Muscatine County, IA",22175,21539,636,2,61767,100
19141,IA,"O'Brien County, IA",8367,8186,181,2,60298,98
19143,IA,"Osceola County, IA",3578,3509,69,3,60702,98
19145,IA,"Page County, IA",6478,6310,168,2,52179,84
19147,IA,"Palo Alto County, IA",4855,4747,108,2,55074,89
19149,IA,"Plymouth County, IA",15033,14695,338,2,69165,112
19151,IA,"Pocahontas County, IA",4589,4501,88,3,56146,91
19153,IA,"Polk County, IA",273646,265893,7753,2,67331,109
19155,IA,"Pottawattamie County, IA",49299,48101,1198,3,60322,98
19157,IA,"Poweshiek County, IA",10539,10258,281,3,57741,93
19159,IA,"Ringgold County, IA",2511,2439,72,2,50890,82
19161,IA,"Sac County, IA",5363,5236,127,3,59392,96
19163,IA,"Scott County, IA",90711,87687,3024,2,65724,106
19165,IA,"Shelby County, IA",6801,6657,144,2,60498,98
19167,IA,"Sioux County, IA",21340,20939,401,2,71566,116
19169,IA,"Story County, IA",59215,58115,1100,3,64151,104
19171,IA,"Tama County, IA",9608,9308,300,2,56281,91
19173,IA,"Taylor County, IA",3247,3185,62,3,51510,83
19175,IA,"Union County, IA",6375,6169,206,3,52914,86
19177,IA,"Van Buren County, IA",3714,3613,101,4,50425,82
19179,IA,"Wapello County, IA",18068,17404,664,3,50533,82
19181,IA,"Warren County, IA",28783,28053,730,3,79557,129
19183,IA,"Washington County, IA",12211,11908,303,3,63230,102
19185,IA,"Wayne County, IA",2848,2774,74,3,49962,81
19187,IA,"Webster County, IA",19774,19159,615,3,53344,86
19189,IA,"Winnebago County, IA",5195,5051,144,3,50258,81
19191,IA,"Winneshiek County, IA",12125,11779,346,3,65482,106
19193,IA,"Woodbury County, IA",56509,54977,1532,3,58419,95
19195,IA,"Worth County, IA",4269,4149,120,3,60139,97
19197,IA,"Wright County, IA",7050,6867,183,3,54251,88
20001,KS,"Allen County, KS",6436,6209,227,3,46690,75
20003,KS,"Anderson County, KS",4178,4041,137,5,51352,83
20005,KS,"Atchison County, KS",6987,6626,361,3,51860,84
20007,KS,"Barber County, KS",2319,2261,58,3,50660,82
20009,KS,"Barton County, KS",13526,13103,423,4,50754,82
20011,KS,"Bourbon County, KS",6700,6416,284,3,47452,77
20013,KS,"Brown County, KS",5352,5183,169,3,47558,77
20015,KS,"Butler County, KS",32491,31442,1049,3,66199,107
20017,KS,"Chase County, KS",1524,1482,42,4,51022,82
20019,KS,"Chautauqua County, KS",1434,1378,56,3,43664,70
20021,KS,"Cherokee County, KS",10136,9788,348,2,47682,77
20023,KS,"Cheyenne County, KS",1310,1278,32,2,47323,76
20025,KS,"Clark County, KS",1072,1047,25,3,59085,95
20027,KS,"Clay County, KS",3777,3656,121,3,52781,85
20029,KS,"Cloud County, KS",3787,3665,122,5,46299,75
20031,KS,"Coffey County, KS",4023,3841,182,3,62715,101
20033,KS,"Comanche County, KS",869,846,23,3,47854,77
20035,KS,"Cowley County, KS",16298,15749,549,4,51537,83
20037,KS,"Crawford County, KS",18729,18003,726,3,42723,69
20039,KS,"Decatur County, KS",1235,1198,37,4,46878,76
20041,KS,"Dickinson County, KS",8842,8528,314,3,58066,94
20043,KS,"Doniphan County, KS",4143,4004,139,3,52596,85
20045,KS,"Douglas County, KS",65375,63457,1918,3,62559,101
20047,KS,"Edwards County, KS",1488,1450,38,4,49047,79
20049,KS,"Elk County, KS",1152,1109,43,2,41930,68
20051,KS,"Ellis County, KS",17036,16649,387,3,51237,83
20053,KS,"Ellsworth County, KS",2748,2671,77,2,56988,92
20055,KS,"Finney County, KS",20602,20121,481,3,57412,93
20057,KS,"Ford County, KS",17088,16664,424,3,54604,88
20059,KS,"Franklin County, KS",14023,13557,466,4,55984,90
20061,KS,"Geary County, KS",11311,10811,500,2,58978,95
20063,KS,"Gove County, KS",1468,1437,31,3,52986,85
20065,KS,"Graham County, KS",1114,1080,34,3,48912,79
20067,KS,"Grant County, KS",3218,3126,92,2,65178,105
20069,KS,"Gray County, KS",3230,3166,64,2,69077,111
20071,KS,"Greeley County, KS",798,780,18,3,58492,94
20073,KS,"Greenwood County, KS",3238,3136,102,2,44876,72
20075,KS,"Hamilton County, KS",1613,1583,30,3,55857,90
20077,KS,"Harper County, KS",2875,2802,73,3,47540,77
20079,KS,"Harvey County, KS",16990,16496,494,2,62961,102
20081,KS,"Haskell County, KS",2208,2158,50,2,62477,101
20083,KS,"Hodgeman County, KS",987,963,24,3,58360,94
20085,KS,"Jackson County, KS",7167,6959,208,3,60615,98
20087,KS,"Jefferson County, KS",10096,9788,308,3,68549,111
20089,KS,"Jewell County, KS",1291,1255,36,3,46017,74
20091,KS,"Johnson County, KS",338777,329456,9321,2,91913,148
20093,KS,"Kearny County, KS",2047,1999,48,3,67301,109
20095,KS,"Kingman County, KS",3434,3325,109,2,56907,92
20097,KS,"Kiowa County, KS",1297,1267,30,4,49588,80
20099,KS,"Labette County, KS",10029,9629,400,3,44170,71
20101,KS,"Lane County, KS",772,752,20,3,60315,97
20103,KS,"Leavenworth County, KS",36474,35225,1249,2,75840,122
20105,KS,"Lincoln County, KS",1681,1642,39,6,47557,77
20107,KS,"Linn County, KS",4440,4176,264,2,62876,101
20109,KS,"Logan County, KS",1623,1590,33,3,53538,86
20111,KS,"Lyon County, KS",16666,16099,567,2,49840,80
20113,KS,"McPherson County, KS",17171,16789,382,3,65834,106
20115,KS,"Marion County, KS",5991,5814,177,3,51771,84
20117,KS,"Marshall County, KS",5492,5335,157,2,55858,90
20119,KS,"Meade County, KS",2155,2105,50,3,64640,104
20121,KS,"Miami County, KS",17476,16898,578,2,74428,120
20123,KS,"Mitchell County, KS",3359,3279,80,4,51979,84
20125,KS,"Montgomery County, KS",14801,14196,605,3,44240,71
20127,KS,"Morris County, KS",2993,2912,81,3,54775,88
20129,KS,"Morton County, KS",1140,1107,33,3,56175,91
20131,KS,"Nemaha County, KS",5368,5220,148,5,63373,102
20133,KS,"Neosho County, KS",6130,5850,280,3,49533,80
20135,KS,"Ness County, KS",1342,1308,34,2,54727,88
20137,KS,"Norton County, KS",2700,2641,59,4,49739,80
20139,KS,"Osage County, KS",7973,7689,284,2,55655,90
20141,KS,"Osborne County, KS",2050,2009,41,3,46351,75
20143,KS,"Ottawa County, KS",3009,2927,82,3,58729,95
20145,KS,"Pawnee County, KS",2873,2791,82,3,65141,105
20147,KS,"Phillips County, KS",2638,2569,69,3,51546,83
20149,KS,"Pottawatomie County, KS",12410,12062,348,3,73685,119
20151,KS,"Pratt County, KS",4907,4783,124,2,53980,87
20153,KS,"Rawlins County, KS",1490,1457,33,3,50768,82
20155,KS,"Reno County, KS",29642,28692,950,3,53371,86
20157,KS,"Republic County, KS",2263,2205,58,3,47082,76
20159,KS,"Rice County, KS",5208,5063,145,3,56350,91
20161,KS,"Riley County, KS",35046,34062,984,4,51996,84
20163,KS,"Rooks County, KS",2538,2448,90,3,49485,80
20165,KS,"Rush County, KS",1632,1586,46,3,53189,86
20167,KS,"Russell County, KS",3296,3200,96,3,46112,74
20169,KS,"Saline County, KS",30176,29269,907,2,56741,92
20171,KS,"Scott County, KS",2832,2778,54,4,62914,101
20173,KS,"Sedgwick County, KS",251155,242477,8678,3,60014,97
20175,KS,"Seward County, KS",9516,9222,294,3,55727,90
20177,KS,"Shawnee County, KS",90410,87395,3015,2,59451,96
20179,KS,"Sheridan County, KS",1405,1374,31,3,54627,88
20181,KS,"Sherman County, KS",2844,2766,78,3,54000,87
20183,KS,"Smith County, KS",1973,1923,50,3,45915,74
20185,KS,"Stafford County, KS",2010,1956,54,3,51007,82
20187,KS,"Stanton County, KS",985,960,25,3,63401,102
20189,KS,"Stevens County, KS",2543,2476,67,3,61264,99
20191,KS,"Sumner County, KS",10903,10537,366,2,53618,86
20193,KS,"Thomas County, KS",4305,4208,97,3,58652,95
20195,KS,"Trego County, KS",1416,1376,40,3,52597,85
20197,KS,"Wabaunsee County, KS",3647,3529,118,3,66168,107
20199,KS,"Wallace County, KS",805,784,21,3,54714,88
20201,KS,"Washington County, KS",2915,2838,77,2,46263,75
20203,KS,"Wichita County, KS",1356,1329,27,4,54009,87
20205,KS,"Wilson County, KS",3947,3791,156,4,46243,75
20207,KS,"Woodson County, KS",1608,1540,68,4,43751,71
20209,KS,"Wyandotte County, KS",77251,73917,3334,4,47292,76
21001,KY,"Adair County, KY",7140,6760,380,4,37650,72
21003,KY,"Allen County, KY",9060,8682,378,4,47307,91
21005,KY,"Anderson County, KY",12091,11643,448,6,61308,117
21007,KY,"Ballard County, KY",3524,3323,201,5,48053,92
21009,KY,"Barren County, KY",18852,18001,851,6,44859,86
21011,KY,"Bath County, KY",4631,4343,288,6,42248,81
21013,KY,"Bell County, KY",8452,7909,543,3,30940,59
21015,KY,"Boone County, KY",71372,68948,2424,4,78806,151
21017,KY,"Bourbon County, KY",9813,9441,372,6,47046,90
21019,KY,"Boyd County, KY",17882,16869,1013,5,50017,96
21021,KY,"Boyle County, KY",12586,11999,587,5,53644,103
21023,KY,"Bracken County, KY",3843,3656,187,8,53289,102
21025,KY,"Breathitt County, KY",3493,3231,262,5,33407,64
21027,KY,"Breckinridge County, KY",7946,7523,423,4,46069,88
21029,KY,"Bullitt County, KY",43068,41294,1774,5,66335,127
21031,KY,"Butler County, KY",5133,4886,247,5,46305,89
21033,KY,"Caldwell County, KY",5473,5200,273,4,44144,85
21035,KY,"Calloway County, KY",18799,18032,767,4,45574,87
21037,KY,"Campbell County, KY",51083,49301,1782,4,66520,127
21039,KY,"Carlisle County, KY",2235,2142,93,4,49659,95
21041,KY,"Carroll County, KY",5329,5117,212,8,51672,99
21043,KY,"Carter County, KY",9783,8971,812,4,43492,83
21045,KY,"Casey County, KY",6704,6424,280,6,34751,67
21047,KY,"Christian County, KY",25085,23683,1402,4,46390,89
21049,KY,"Clark County, KY",17255,16576,679,7,55428,106
21051,KY,"Clay County, KY",5196,4831,365,6,30175,58
21053,KY,"Clinton County, KY",4009,3788,221,5,34005,65
21055,KY,"Crittenden County, KY",3810,3625,185,4,44595,85
21057,KY,"Cumberland County, KY",3185,3051,134,4,34897,67
21059,KY,"Daviess County, KY",47567,45730,1837,5,52620,101
21061,KY,"Edmonson County, KY",4841,4602,239,8,47482,91
21063,KY,"Elliott County, KY",2041,1873,168,5,34262,66
21065,KY,"Estill County, KY",5388,5120,268,3,35004,67
21067,KY,"Fayette County, KY",175864,170028,5836,5,58981,113
21069,KY,"Fleming County, KY",6200,5866,334,6,43943,84
21071,KY,"Floyd County, KY",11048,10340,708,4,35828,69
21073,KY,"Franklin County, KY",25333,24392,941,6,58917,113
21075,KY,"Fulton County, KY",2058,1941,117,4,34376,66
21077,KY,"Gallatin County, KY",4109,3945,164,5,55273,106
21079,KY,"Garrard County, KY",7710,7352,358,4,51757,99
21081,KY,"Grant County, KY",11795,11307,488,5,55210,106
21083,KY,"Graves County, KY",15849,15122,727,5,48038,92
21085,KY,"Grayson County, KY",11029,10477,552,4,43771,84
21087,KY,"Green County, KY",5125,4901,224,7,38896,74
21089,KY,"Greenup County, KY",13444,12560,884,4,52179,100
21091,KY,"Hancock County, KY",3994,3841,153,4,60626,116
21093,KY,"Hardin County, KY",49305,47280,2025,10,57711,110
21095,KY,"Harlan County, KY",6717,6072,645,4,30050,58
21097,KY,"Harrison County, KY",8836,8457,379,5,51475,99
21099,KY,"Hart County, KY",7960,7582,378,4,42718,82
21101,KY,"Henderson County, KY",22116,21270,846,4,53199,102
21103,KY,"Henry County, KY",8273,7970,303,5,51806,99
21105,KY,"Hickman County, KY",1776,1690,86,5,52331,100
21107,KY,"Hopkins County, KY",18562,17714,848,7,48769,93
21109,KY,"Jackson County, KY",4132,3865,267,4,34940,67
21111,KY,"Jefferson County, KY",402518,386373,16145,4,59025,113
21113,KY,"Jessamine County, KY",26666,25695,971,7,62533,120
21115,KY,"Johnson County, KY",6771,6324,447,4,31202,60
21117,KY,"Kenton County, KY",88326,85189,3137,7,68692,132
21119,KY,"Knott County, KY",4499,4189,310,6,32613,62
21121,KY,"Knox County, KY",9946,9351,595,5,31634,61
21123,KY,"Larue County, KY",6008,5737,271,5,49785,95
21125,KY,"Laurel County, KY",24692,23483,1209,7,44033,84
21127,KY,"Lawrence County, KY",5200,4833,367,6,38055,73
21129,KY,"Lee County, KY",2064,1947,117,8,30905,59
21131,KY,"Leslie County, KY",2704,2481,223,7,32202,62
21133,KY,"Letcher County, KY",6333,5862,471,9,32435,62
21135,KY,"Lewis County, KY",4654,4241,413,5,37410,72
21137,KY,"Lincoln County, KY",9349,8877,472,6,43220,83
21139,KY,"Livingston County, KY",3669,3459,210,4,50521,97
21141,KY,"Logan County, KY",12621,12112,509,5,48902,94
21143,KY,"Lyon County, KY",3119,2973,146,5,52978,101
21145,KY,"McCracken County, KY",29258,27819,1439,6,48219,92
21147,KY,"McCreary County, KY",4702,4418,284,4,32701,63
21149,KY,"McLean County, KY",4233,4046,187,4,51184,98
21151,KY,"Madison County, KY",47575,45743,1832,11,50316,96
21153,KY,"Magoffin County, KY",3136,2790,346,4,32045,61
21155,KY,"Marion County, KY",9744,9368,376,5,48062,92
21157,KY,"Marshall County, KY",15138,14433,705,7,57945,111
21159,KY,"Martin County, KY",2772,2582,190,6,34291,66
21161,KY,"Mason County, KY",7134,6723,411,5,47861,92
21163,KY,"Meade County, KY",12345,11775,570,7,54946,105
21165,KY,"Menifee County, KY",2326,2165,161,5,37457,72
21167,KY,"Mercer County, KY",10070,9602,468,5,55267,106
21169,KY,"Metcalfe County, KY",4106,3909,197,4,38978,75
21171,KY,"Monroe County, KY",4700,4516,184,5,36512,70
21173,KY,"Montgomery County, KY",11705,11084,621,5,52903,101
21175,KY,"Morgan County, KY",4588,4342,246,6,37433,72
21177,KY,"Muhlenberg County, KY",10541,9890,651,5,45049,86
21179,KY,"Nelson County, KY",23276,22217,1059,4,64795,124
21181,KY,"Nicholas County, KY",3295,3149,146,5,38084,73
21183,KY,"Ohio County, KY",9827,9326,501,3,47542,91
21185,KY,"Oldham County, KY",33501,32403,1098,5,101152,194
21187,KY,"Owen County, KY",5138,4902,236,7,51494,99
21189,KY,"Owsley County, KY",1135,1055,80,4,28727,55
21191,KY,"Pendleton County, KY",7021,6754,267,6,58962,113
21193,KY,"Perry County, KY",8294,7792,502,6,38000,73
21195,KY,"Pike County, KY",19977,18819,1158,5,36875,71
21197,KY,"Powell County, KY",5046,4775,271,5,41760,80
21199,KY,"Pulaski County, KY",26745,25493,1252,5,43568,83
21201,KY,"Robertson County, KY",819,775,44,5,47017,90
21203,KY,"Rockcastle County, KY",6718,6397,321,5,40790,78
21205,KY,"Rowan County, KY",10456,9904,552,6,44068,84
21207,KY,"Russell County, KY",6251,5894,357,4,44056,84
21209,KY,"Scott County, KY",29281,28256,1025,3,74719,143
21211,KY,"Shelby County, KY",25657,24781,876,5,71737,137
21213,KY,"Simpson County, KY",8943,8538,405,4,52931,101
21215,KY,"Spencer County, KY",10268,9903,365,4,79863,153
21217,KY,"Taylor County, KY",12757,12212,545,4,48485,93
21219,KY,"Todd County, KY",5447,5232,215,5,47742,91
21221,KY,"Trigg County, KY",6024,5741,283,4,49955,96
21223,KY,"Trimble County, KY",3902,3732,170,5,58998,113
21225,KY,"Union County, KY",6139,5863,276,4,49870,95
21227,KY,"Warren County, KY",65388,62844,2544,4,53238,102
21229,KY,"Washington County, KY",6267,6022,245,6,51286,98
21231,KY,"Wayne County, KY",7465,7033,432,4,34449,66
21233,KY,"Webster County, KY",5790,5556,234,5,49079,94
21235,KY,"Whitley County, KY",13737,13029,708,7,38191,73
21237,KY,"Wolfe County, KY",1968,1828,140,3,32773,63
21239,KY,"Woodford County, KY",14949,14481,468,5,67815,130
22001,LA,"Acadia Parish, LA",23841,22572,1269,6,44728,88
22003,LA,"Allen Parish, LA",8811,8312,499,4,47111,92
22005,LA,"Ascension Parish, LA",63953,61318,2635,6,83072,163
22007,LA,"Assumption Parish, LA",8877,8335,542,6,51763,101
22009,LA,"Avoyelles Parish, LA",15109,14226,883,5,38316,75
22011,LA,"Beauregard Parish, LA",14606,13849,757,6,55343,108
22013,LA,"Bienville Parish, LA",5516,5190,326,4,37198,73
22015,LA,"Bossier Parish, LA",57604,55129,2475,5,54080,106
22017,LA,"Caddo Parish, LA",103405,97859,5546,4,45613,89
22019,LA,"Calcasieu Parish, LA",106140,101802,4338,6,53050,104
22021,LA,"Caldwell Parish, LA",3773,3544,229,4,44007,86
22023,LA,"Cameron Parish, LA",3937,3789,148,6,60317,118
22025,LA,"Catahoula Parish, LA",3379,3162,217,6,36794,72
22027,LA,"Claiborne Parish, LA",5837,5506,331,7,36497,71
22029,LA,"Concordia Parish, LA",7019,6566,453,6,36276,71
22031,LA,"De Soto Parish, LA",10853,10201,652,4,47347,93
22033,LA,"East Baton Rouge Parish, LA",230493,220337,10156,11,56303,110
22035,LA,"East Carroll Parish, LA",1888,1688,200,5,29943,59
22037,LA,"East Feliciana Parish, LA",7973,7606,367,6,50041,98
22039,LA,"Evangeline Parish, LA",11889,11186,703,7,35146,69
22041,LA,"Franklin Parish, LA",7363,6834,529,6,35484,69
22043,LA,"Grant Parish, LA",8171,7696,475,5,49544,97
22045,LA,"Iberia Parish, LA",28099,26574,1525,6,47731,93
22047,LA,"Iberville Parish, LA",14040,13207,833,5,55198,108
22049,LA,"Jackson Parish, LA",6802,6480,322,4,43232,85
22051,LA,"Jefferson Parish, LA",213704,204775,8929,5,55909,109
22053,LA,"Jefferson Davis Parish, LA",13231,12607,624,4,47988,94
22055,LA,"Lafayette Parish, LA",113607,108685,4922,5,60053,118
22057,LA,"Lafourche Parish, LA",42008,40124,1884,4,54145,106
22059,LA,"LaSalle Parish, LA",6715,6429,286,5,51014,100
22061,LA,"Lincoln Parish, LA",21959,20780,1179,4,41608,81
22063,LA,"Livingston Parish, LA",68713,65912,2801,8,63852,125
22065,LA,"Madison Parish, LA",3515,3232,283,8,32229,63
22067,LA,"Morehouse Parish, LA",9999,9166,833,6,34922,68
22069,LA,"Natchitoches Parish, LA",16343,15356,987,5,49536,97
22071,LA,"Orleans Parish, LA",178834,170121,8713,5,45092,88
22073,LA,"Ouachita Parish, LA",70082,66346,3736,4,43235,85
22075,LA,"Plaquemines Parish, LA",10053,9620,433,5,60795,119
22077,LA,"Pointe Coupee Parish, LA",9867,9339,528,5,48011,94
22079,LA,"Rapides Parish, LA",55062,52258,2804,5,49687,97
22081,LA,"Red River Parish, LA",3745,3553,192,6,39806,78
22083,LA,"Richland Parish, LA",8222,7704,518,5,39586,78
22085,LA,"Sabine Parish, LA",9172,8705,467,5,45486,89
22087,LA,"St. Bernard Parish, LA",19854,18885,969,4,45806,90
22089,LA,"St. Charles Parish, LA",25134,24049,1085,6,71579,140
22091,LA,"St. Helena Parish, LA",4273,4013,260,6,43376,85
22093,LA,"St. James Parish, LA",9229,8675,554,6,57250,112
22095,LA,"St. John the Baptist Parish, LA",19647,18545,1102,6,54944,108
22097,LA,"St. Landry Parish, LA",31891,29891,2000,5,39599,78
22099,LA,"St. Martin Parish, LA",22189,21056,1133,6,47247,92
22101,LA,"St. Mary Parish, LA",19816,18643,1173,4,40918,80
22103,LA,"St. Tammany Parish, LA",119300,114335,4965,6,71526,140
22105,LA,"Tangipahoa Parish, LA",54444,51437,3007,8,47860,94
22107,LA,"Tensas Parish, LA",1398,1282,116,5,31436,62
22109,LA,"Terrebonne Parish, LA",46285,44140,2145,6,51719,101
22111,LA,"Union Parish, LA",9098,8570,528,5,44617,87
22113,LA,"Vermilion Parish, LA",24087,22870,1217,6,50193,98
22115,LA,"Vernon Parish, LA",15883,14906,977,6,51652,101
22117,LA,"Washington Parish, LA",16703,15713,990,6,35505,70
22119,LA,"Webster Parish, LA",14493,13609,884,5,38386,75
22121,LA,"West Baton Rouge Parish, LA",13648,13029,619,11,65344,128
22123,LA,"West Carroll Parish, LA",3630,3243,387,4,42614,83
22125,LA,"West Feliciana Parish, LA",5378,5158,220,6,65296,128
22127,LA,"Winn Parish, LA",4867,4558,309,3,43166,85
23001,ME,"Androscoggin County, ME",55225,53594,1631,5,58958,100
23003,ME,"Aroostook County, ME",30205,28814,1391,2,40675,69
23005,ME,"Cumberland County, ME",164832,160912,3920,4,75254,128
23007,ME,"Franklin County, ME",14241,13693,548,4,51136,87
23009,ME,"Hancock County, ME",29089,28064,1025,3,58926,100
23011,ME,"Kennebec County, ME",61923,60100,1823,3,55358,94
23013,ME,"Knox County, ME",20194,19605,589,3,55910,95
23015,ME,"Lincoln County, ME",16789,16290,499,4,58619,100
23017,ME,"Oxford County, ME",26333,25381,952,3,50344,86
23019,ME,"Penobscot County, ME",76836,74339,2497,4,50702,86
23021,ME,"Piscataquis County, ME",7274,7003,271,2,43509,74
23023,ME,"Sagadahoc County, ME",19421,18975,446,5,65841,112
23025,ME,"Somerset County, ME",22429,21428,1001,3,45333,77
23027,ME,"Waldo County, ME",20613,19953,660,5,51073,87
23029,ME,"Washington County, ME",13688,13053,635,3,39068,66
23031,ME,"York County, ME",113644,110554,3090,4,66803,114
24001,MD,"Allegany County, MD",32491,30812,1679,3,48170,56
24003,MD,"Anne Arundel County, MD",317780,308068,9712,4,100916,117
24005,MD,"Baltimore County, MD",457555,440638,16917,3,76972,89
24009,MD,"Calvert County, MD",50484,48888,1596,4,111056,128
24011,MD,"Caroline County, MD",18270,17612,658,3,60143,69
24013,MD,"Carroll County, MD",96466,93645,2821,4,101810,118
24015,MD,"Cecil County, MD",53453,51323,2130,4,75307,87
24017,MD,"Charles County, MD",88102,84908,3194,5,102510,118
24019,MD,"Dorchester County, MD",15684,14938,746,3,48709,56
24021,MD,"Frederick County, MD",135761,131453,4308,4,102951,119
24023,MD,"Garrett County, MD",15775,15075,700,3,59253,68
24025,MD,"Harford County, MD",142081,137331,4750,3,91492,106
24027,MD,"Howard County, MD",189135,183944,5191,4,121329,140
24029,MD,"Kent County, MD",10205,9796,409,3,65615,76
24031,MD,"Montgomery County, MD",565866,549310,16556,4,110012,127
24033,MD,"Prince George's County, MD",513953,494665,19288,3,85357,99
24035,MD,"Queen Anne's County, MD",28079,27210,869,3,101350,117
24037,MD,"St. Mary's County, MD",57409,55506,1903,6,89123,103
24039,MD,"Somerset County, MD",9252,8689,563,3,38731,45
24041,MD,"Talbot County, MD",19327,18665,662,4,75714,87
24043,MD,"Washington County, MD",75259,72347,2912,5,59785,69
24045,MD,"Wicomico County, MD",51724,49327,2397,7,54351,63
24047,MD,"Worcester County, MD",25814,23908,1906,5,65821,76
24510,MD,"Baltimore city, MD",290743,275911,14832,3,49780,58
25001,MA,"Barnstable County, MA",115437,110989,4448,4,82686,97
25003,MA,"Berkshire County, MA",65320,63035,2285,4,58805,69
25005,MA,"Bristol County, MA",304217,292890,11327,4,69857,82
25007,MA,"Dukes County, MA",9650,9255,395,3,76036,89
25009,MA,"Essex County, MA",429871,417092,12779,3,83253,97
25011,MA,"Franklin County, MA",41318,40207,1111,4,60143,70
25013,MA,"Hampden County, MA",230190,220767,9423,3,59918,70
25015,MA,"Hampshire County, MA",90937,88479,2458,2,74142,87
25017,MA,"Middlesex County, MA",929265,907777,21488,4,106543,124
25019,MA,"Nantucket County/town, MA",7661,7342,319,3,96030,112
25021,MA,"Norfolk County, MA",395483,385482,10001,3,106851,125
25023,MA,"Plymouth County, MA",286588,277913,8675,3,90584,106
25025,MA,"Suffolk County, MA",461168,449136,12032,3,75843,89
25027,MA,"Worcester County, MA",450332,436193,14139,4,77795,91
26001,MI,"Alcona County, MI",3879,3635,244,8,41491,70
26003,MI,"Alger County, MI",3198,2949,249,3,52285,88
26005,MI,"Allegan County, MI",62275,60325,1950,5,66568,112
26007,MI,"Alpena County, MI",13266,12638,628,5,43676,73
26009,MI,"Antrim County, MI",10321,9791,530,7,58317,98
26011,MI,"Arenac County, MI",6062,5663,399,6,44017,74
26013,MI,"Baraga County, MI",3219,3015,204,3,48371,81
26015,MI,"Barry County, MI",31665,30638,1027,5,67703,114
26017,MI,"Bay County, MI",50038,47704,2334,5,50130,84
26019,MI,"Benzie County, MI",8882,8432,450,4,56934,96
26021,MI,"Berrien County, MI",73454,70483,2971,4,50659,85
26023,MI,"Branch County, MI",19356,18600,756,4,52255,88
26025,MI,"Calhoun County, MI",62502,59943,2559,4,50205,84
26027,MI,"Cass County, MI",24491,23442,1049,5,55029,93
26029,MI,"Charlevoix County, MI",12913,12315,598,9,58831,99
26031,MI,"Cheboygan County, MI",10547,9627,920,6,47876,80
26033,MI,"Chippewa County, MI",16031,15022,1009,6,49610,83
26035,MI,"Clare County, MI",11728,11010,718,3,42480,71
26037,MI,"Clinton County, MI",41149,39916,1233,6,72666,122
26039,MI,"Crawford County, MI",5599,5285,314,5,49114,83
26041,MI,"Delta County, MI",17181,16282,899,4,48880,82
26043,MI,"Dickinson County, MI",12297,11777,520,3,53751,90
26045,MI,"Eaton County, MI",57251,55295,1956,5,65891,111
26047,MI,"Emmet County, MI",17772,16816,956,5,59456,100
26049,MI,"Genesee County, MI",182899,173888,9011,6,50554,85
26051,MI,"Gladwin County, MI",9918,9350,568,5,46458,78
26053,MI,"Gogebic County, MI",6030,5714,316,3,39030,66
26055,MI,"Grand Traverse County, MI",49812,48097,1715,4,65041,109
26057,MI,"Gratiot County, MI",17998,17209,789,4,51046,86
26059,MI,"Hillsdale County, MI",20446,19592,854,5,50015,84
26061,MI,"Houghton County, MI",16183,15388,795,4,45006,76
26063,MI,"Huron County, MI",15401,14723,678,4,49126,83
26065,MI,"Ingham County, MI",151261,145943,5318,3,54704,92
26067,MI,"Ionia County, MI",30280,29252,1028,6,59582,100
26069,MI,"Iosco County, MI",10220,9610,610,6,43605,73
26071,MI,"Iron County, MI",5162,4878,284,4,46814,79
26073,MI,"Isabella County, MI",34741,33405,1336,4,46677,78
26075,MI,"Jackson County, MI",74125,71335,2790,3,56001,94
26077,MI,"Kalamazoo County, MI",133718,129316,4402,6,56739,95
26079,MI,"Kalkaska County, MI",7935,7487,448,3,47620,80
26081,MI,"Kent County, MI",359924,349535,10389,7,66560,112
26083,MI,"Keweenaw County, MI",884,823,61,6,47318,80
26085,MI,"Lake County, MI",3709,3472,237,5,38044,64
26087,MI,"Lapeer County, MI",41517,39273,2244,4,66415,112
26089,MI,"Leelanau County, MI",10531,10139,392,4,72888,123
26091,MI,"Lenawee County, MI",46454,44663,1791,3,55466,93
26093,MI,"Livingston County, MI",104220,100768,3452,6,87827,148
26095,MI,"Luce County, MI",2315,2172,143,9,45464,76
26097,MI,"Mackinac County, MI",5135,4656,479,4,44986,76
26099,MI,"Macomb County, MI",451125,432001,19124,6,65051,109
26101,MI,"Manistee County, MI",10444,9873,571,5,50047,84
26103,MI,"Marquette County, MI",32543,30975,1568,5,54913,92
26105,MI,"Mason County, MI",13666,12996,670,5,49869,84
26107,MI,"Mecosta County, MI",18247,17390,857,4,47705,80
26109,MI,"Menominee County, MI",11054,10612,442,4,49189,83
26111,MI,"Midland County, MI",40325,38826,1499,5,69859,117
26113,MI,"Missaukee County, MI",6961,6629,332,4,51317,86
26115,MI,"Monroe County, MI",75480,72541,2939,4,64341,108
26117,MI,"Montcalm County, MI",28350,27196,1154,8,52089,88
26119,MI,"Montmorency County, MI",2998,2748,250,4,40126,67
26121,MI,"Muskegon County, MI",77149,73860,3289,4,50730,85
26123,MI,"Newaygo County, MI",23400,22413,987,3,51772,87
26125,MI,"Oakland County, MI",680255,657035,23220,6,81257,137
26127,MI,"Oceana County, MI",12120,11403,717,7,52319,88
26129,MI,"Ogemaw County, MI",8030,7494,536,7,41347,70
26131,MI,"Ontonagon County, MI",2090,1947,143,4,45531,77
26133,MI,"Osceola County, MI",11202,10749,453,7,47343,80
26135,MI,"Oscoda County, MI",3045,2836,209,5,44594,75
26137,MI,"Otsego County, MI",11638,11062,576,3,52392,88
26139,MI,"Ottawa County, MI",161102,156664,4438,8,69827,117
26141,MI,"Presque Isle County, MI",4951,4576,375,8,47339,80
26143,MI,"Roscommon County, MI",7726,7145,581,5,42546,72
26145,MI,"Saginaw County, MI",86666,82533,4133,5,48471,81
26147,MI,"St. Clair County, MI",76280,72546,3734,4,60208,101
26149,MI,"St. Joseph County, MI",27976,26783,1193,5,54024,91
26151,MI,"Sanilac County, MI",19490,18565,925,7,49917,84
26153,MI,"Schoolcraft County, MI",3326,3093,233,4,50256,84
26155,MI,"Shiawassee County, MI",33496,32070,1426,5,55633,94
26157,MI,"Tuscola County, MI",23853,22635,1218,5,52342,88
26159,MI,"Van Buren County, MI",35167,33559,1608,3,58733,99
26161,MI,"Washtenaw County, MI",198198,192472,5726,5,76728,129
26163,MI,"Wayne County, MI",808171,767123,41048,5,50753,85
26165,MI,"Wexford County, MI",14854,14185,669,3,53146,89
27001,MN,"Aitkin County, MN",7268,6818,450,3,51936,70
27003,MN,"Anoka County, MN",199416,193301,6115,4,83363,112
27005,MN,"Becker County, MN",18833,18086,747,4,61311,82
27007,MN,"Beltrami County, MN",24532,23487,1045,4,54638,73
27009,MN,"Benton County, MN",22144,21287,857,4,63395,85
27011,MN,"Big Stone County, MN",2507,2402,105,3,52692,71
27013,MN,"Blue Earth County, MN",40878,39748,1130,4,60408,81
27015,MN,"Brown County, MN",14435,13912,523,5,62904,84
27017,MN,"Carlton County, MN",17927,17126,801,3,65749,88
27019,MN,"Carver County, MN",59102,57473,1629,6,101891,137
27021,MN,"Cass County, MN",14467,13668,799,4,54267,73
27023,MN,"Chippewa County, MN",6978,6707,271,4,54984,74
27025,MN,"Chisago County, MN",30246,29106,1140,3,84811,114
27027,MN,"Clay County, MN",36268,35165,1103,8,64874,87
27029,MN,"Clearwater County, MN",4501,4130,371,4,54896,74
27031,MN,"Cook County, MN",3123,2988,135,4,58664,79
27033,MN,"Cottonwood County, MN",5963,5743,220,4,53725,72
27035,MN,"Crow Wing County, MN",32410,31005,1405,3,60384,81
27037,MN,"Dakota County, MN",243793,236782,7011,3,89075,120
27039,MN,"Dodge County, MN",11982,11577,405,3,86436,116
27041,MN,"Douglas County, MN",21134,20466,668,4,67592,91
27043,MN,"Faribault County, MN",7077,6783,294,3,54193,73
27045,MN,"Fillmore County, MN",11664,11279,385,3,62716,84
27047,MN,"Freeborn County, MN",16216,15659,557,3,56716,76
27049,MN,"Goodhue County, MN",27240,26410,830,5,71497,96
27051,MN,"Grant County, MN",3324,3176,148,3,55247,74
27053,MN,"Hennepin County, MN",712531,692855,19676,3,82323,111
27055,MN,"Houston County, MN",10451,10115,336,5,64920,87
27057,MN,"Hubbard County, MN",10036,9495,541,4,56064,75
27059,MN,"Isanti County, MN",21503,20632,871,6,77963,105
27061,MN,"Itasca County, MN",21963,20656,1307,3,58660,79
27063,MN,"Jackson County, MN",5754,5556,198,6,57915,78
27065,MN,"Kanabec County, MN",9111,8573,538,4,63595,85
27067,MN,"Kandiyohi County, MN",24425,23565,860,4,64129,86
27069,MN,"Kittson County, MN",2386,2299,87,6,62762,84
27071,MN,"Koochiching County, MN",5990,5608,382,4,52545,71
27073,MN,"Lac qui Parle County, MN",3579,3445,134,4,56825,76
27075,MN,"Lake County, MN",5538,5338,200,4,61082,82
27077,MN,"Lake of the Woods County, MN",2472,2370,102,5,56244,76
27079,MN,"Le Sueur County, MN",16307,15576,731,4,75519,101
27081,MN,"Lincoln County, MN",3290,3166,124,3,55328,74
27083,MN,"Lyon County, MN",14631,14163,468,4,63849,86
27085,MN,"McLeod County, MN",19408,18690,718,5,64380,86
27087,MN,"Mahnomen County, MN",2305,2196,109,6,46702,63
27089,MN,"Marshall County, MN",5447,5128,319,4,59793,80
27091,MN,"Martin County, MN",10145,9764,381,4,54602,73
27093,MN,"Meeker County, MN",13426,12907,519,5,63812,86
27095,MN,"Mille Lacs County, MN",13055,12347,708,5,59262,80
27097,MN,"Morrison County, MN",17653,16738,915,3,61847,83
27099,MN,"Mower County, MN",20463,19842,621,4,55276,74
27101,MN,"Murray County, MN",4877,4668,209,3,61007,82
27103,MN,"Nicollet County, MN",21098,20564,534,3,71067,95
27105,MN,"Nobles County, MN",11289,10950,339,5,57300,77
27107,MN,"Norman County, MN",3284,3127,157,3,53961,72
27109,MN,"Olmsted County, MN",89236,86958,2278,4,80631,108
27111,MN,"Otter Tail County, MN",31655,30335,1320,5,59901,80
27113,MN,"Pennington County, MN",8765,8365,400,6,55870,75
27115,MN,"Pine County, MN",15154,14318,836,4,55684,75
27117,MN,"Pipestone County, MN",4950,4778,172,4,55405,74
27119,MN,"Polk County, MN",16672,16007,665,3,60582,81
27121,MN,"Pope County, MN",6582,6378,204,3,59442,80
27123,MN,"Ramsey County, MN",292118,283424,8694,5,68652,92
27125,MN,"Red Lake County, MN",2229,2111,118,4,58384,78
27127,MN,"Redwood County, MN",7676,7392,284,5,60097,81
27129,MN,"Renville County, MN",8669,8275,394,3,59110,79
27131,MN,"Rice County, MN",37333,36169,1164,2,72438,97
27133,MN,"Rock County, MN",5687,5556,131,4,63451,85
27135,MN,"Roseau County, MN",7875,7570,305,4,62924,84
27137,MN,"St. Louis County, MN",102395,98297,4098,3,60228,81
27139,MN,"Scott County, MN",84276,81967,2309,4,108718,146
27141,MN,"Sherburne County, MN",52921,51063,1858,4,95323,128
27143,MN,"Sibley County, MN",8661,8331,330,3,66757,90
27145,MN,"Stearns County, MN",91177,88280,2897,3,66449,89
27147,MN,"Steele County, MN",21221,20549,672,3,68603,92
27149,MN,"Stevens County, MN",5478,5330,148,4,59045,79
27151,MN,"Swift County, MN",4953,4737,216,4,60127,81
27153,MN,"Todd County, MN",13615,13012,603,4,51746,69
27155,MN,"Traverse County, MN",1781,1715,66,3,57602,77
27157,MN,"Wabasha County, MN",12432,12018,414,6,63435,85
27159,MN,"Wadena County, MN",5962,5595,367,4,50663,68
27161,MN,"Waseca County, MN",9059,8709,350,3,63907,86
27163,MN,"Washington County, MN",144620,140553,4067,4,100857,135
27165,MN,"Watonwan County, MN",6531,6267,264,3,57290,77
27167,MN,"Wilkin County, MN",3516,3397,119,3,69890,94
27169,MN,"Winona County, MN",28840,28005,835,3,64219,86
27171,MN,"Wright County, MN",76368,73883,2485,4,91374,123
27173,MN,"Yellow Medicine County, MN",5409,5204,205,5,61074,82
28001,MS,"Adams County, MS",11260,10466,794,5,34583,75
28003,MS,"Alcorn County, MS",16057,15300,757,7,43496,95
28005,MS,"Amite County, MS",4417,4109,308,6,41575,91
28007,MS,"Attala County, MS",7031,6592,439,6,36905,80
28009,MS,"Benton County, MS",3055,2868,187,7,37875,83
28011,MS,"Bolivar County, MS",12260,11397,863,6,30309,66
28013,MS,"Calhoun County, MS",5660,5350,310,6,38648,84
28015,MS,"Carroll County, MS",3471,3253,218,6,44885,98
28017,MS,"Chickasaw County, MS",6921,6531,390,6,37533,82
28019,MS,"Choctaw County, MS",3757,3552,205,11,41146,90
28021,MS,"Claiborne County, MS",3030,2705,325,6,31221,68
28023,MS,"Clarke County, MS",5923,5554,369,8,42826,93
28025,MS,"Clay County, MS",7794,7213,581,8,33653,73
28027,MS,"Coahoma County, MS",8364,7722,642,7,30242,66
28029,MS,"Copiah County, MS",11233,10490,743,5,42299,92
28031,MS,"Covington County, MS",8143,7745,398,4,42076,92
28033,MS,"DeSoto County, MS",91399,87382,4017,5,67450,147
28035,MS,"Forrest County, MS",33282,31575,1707,7,40224,88
28037,MS,"Franklin County, MS",2807,2616,191,7,41420,90
28039,MS,"George County, MS",8841,8185,656,8,51858,113
28041,MS,"Greene County, MS",4355,4014,341,5,48641,106
28043,MS,"Grenada County, MS",9494,9014,480,6,40561,88
28045,MS,"Hancock County, MS",18776,17720,1056,5,50401,110
28047,MS,"Harrison County, MS",86479,82022,4457,5,49619,108
28049,MS,"Hinds County, MS",107145,101524,5621,10,44773,98
28051,MS,"Holmes County, MS",5672,5089,583,10,26348,57
28053,MS,"Humphreys County, MS",2227,2003,224,11,28464,62
28055,MS,"Issaquena County, MS",381,338,43,5,30944,67
28057,MS,"Itawamba County, MS",10529,10034,495,6,49214,107
28059,MS,"Jackson County, MS",58591,55058,3533,7,53414,116
28061,MS,"Jasper County, MS",6185,5762,423,16,40923,89
28063,MS,"Jefferson County, MS",2028,1714,314,7,30871,67
28065,MS,"Jefferson Davis County, MS",4124,3840,284,5,32077,70
28067,MS,"Jones County, MS",26252,24839,1413,8,41733,91
28069,MS,"Kemper County, MS",3555,3271,284,5,33472,73
28071,MS,"Lafayette County, MS",28393,27113,1280,4,54034,118
28073,MS,"Lamar County, MS",30722,29435,1287,6,62606,136
28075,MS,"Lauderdale County, MS",30536,28862,1674,7,41604,91
28077,MS,"Lawrence County, MS",4623,4310,313,6,43668,95
28079,MS,"Leake County, MS",7968,7527,441,4,41007,89
28081,MS,"Lee County, MS",41209,39409,1800,8,50803,111
28083,MS,"Leflore County, MS",10018,9262,756,6,29687,65
28085,MS,"Lincoln County, MS",14635,13813,822,5,45062,98
28087,MS,"Lowndes County, MS",25441,24086,1355,4,49251,107
28089,MS,"Madison County, MS",53328,51001,2327,6,70824,154
28091,MS,"Marion County, MS",9940,9397,543,6,38402,84
28093,MS,"Marshall County, MS",14505,13673,832,6,43107,94
28095,MS,"Monroe County, MS",15534,14683,851,6,42464,93
28097,MS,"Montgomery County, MS",3960,3721,239,6,38475,84
28099,MS,"Neshoba County, MS",10244,9640,604,6,41795,91
28101,MS,"Newton County, MS",8856,8371,485,7,42962,94
28103,MS,"Noxubee County, MS",3783,3507,276,6,32916,72
28105,MS,"Oktibbeha County, MS",22722,21447,1275,7,41631,91
28107,MS,"Panola County, MS",12553,11726,827,5,40655,89
28109,MS,"Pearl River County, MS",23847,22609,1238,7,45874,100
28111,MS,"Perry County, MS",4293,4004,289,7,43106,94
28113,MS,"Pike County, MS",14519,13575,944,4,35044,76
28115,MS,"Pontotoc County, MS",14773,14133,640,5,48910,107
28117,MS,"Prentiss County, MS",11338,10781,557,8,43465,95
28119,MS,"Quitman County, MS",2378,2182,196,4,29318,64
28121,MS,"Rankin County, MS",76230,73226,3004,5,67284,147
28123,MS,"Scott County, MS",12721,12149,572,8,41532,90
28125,MS,"Sharkey County, MS",1604,1469,135,5,31138,68
28127,MS,"Simpson County, MS",10765,10209,556,5,47664,104
28129,MS,"Smith County, MS",6822,6466,356,7,46296,101
28131,MS,"Stone County, MS",6876,6425,451,9,47187,103
28133,MS,"Sunflower County, MS",7736,7051,685,6,32948,72
28135,MS,"Tallahatchie County, MS",5276,4970,306,6,31915,70
28137,MS,"Tate County, MS",12394,11696,698,5,50188,109
28139,MS,"Tippah County, MS",9442,8960,482,5,44696,97
28141,MS,"Tishomingo County, MS",8629,8189,440,6,43341,94
28143,MS,"Tunica County, MS",4459,4183,276,4,33993,74
28145,MS,"Union County, MS",14222,13628,594,7,49320,107
28147,MS,"Walthall County, MS",4933,4574,359,6,35465,77
28149,MS,"Warren County, MS",20335,19109,1226,8,46606,102
28151,MS,"Washington County, MS",16985,15701,1284,6,31018,68
28153,MS,"Wayne County, MS",7444,6990,454,6,39036,85
28155,MS,"Webster County, MS",3987,3762,225,10,46110,100
28157,MS,"Wilkinson County, MS",2811,2526,285,6,32612,71
28159,MS,"Winston County, MS",7425,6973,452,6,37596,82
28161,MS,"Yalobusha County, MS",4983,4698,285,6,40515,88
28163,MS,"Yazoo County, MS",9424,8825,599,3,34817,76
29001,MO,"Adair County, MO",10345,9945,400,3,43044,75
29003,MO,"Andrew County, MO",9767,9494,273,4,62823,110
29005,MO,"Atchison County, MO",2703,2603,100,3,50516,88
29007,MO,"Audrain County, MO",10697,10337,360,4,45609,80
29009,MO,"Barry County, MO",15589,15044,545,3,47155,82
29011,MO,"Barton County, MO",5202,5026,176,4,46397,81
29013,MO,"Bates County, MO",7908,7590,318,5,48442,84
29015,MO,"Benton County, MO",7201,6855,346,4,42144,74
29017,MO,"Bollinger County, MO",5484,5270,214,2,45868,80
29019,MO,"Boone County, MO",98300,95937,2363,3,58029,101
29021,MO,"Buchanan County, MO",44669,43301,1368,5,49216,86
29023,MO,"Butler County, MO",17986,17140,846,3,41327,72
29025,MO,"Caldwell County, MO",4369,4230,139,3,52872,92
29027,MO,"Callaway County, MO",21383,20758,625,5,58720,102
29029,MO,"Camden County, MO",18861,18013,848,3,51460,90
29031,MO,"Cape Girardeau County, MO",40851,39654,1197,3,57618,100
29033,MO,"Carroll County, MO",4808,4653,155,5,50628,88
29035,MO,"Carter County, MO",2546,2421,125,3,36383,63
29037,MO,"Cass County, MO",54895,53239,1656,4,73882,129
29039,MO,"Cedar County, MO",5764,5550,214,3,38427,67
29041,MO,"Chariton County, MO",3727,3614,113,3,50589,88
29043,MO,"Christian County, MO",44998,43771,1227,4,63400,111
29045,MO,"Clark County, MO",3205,3091,114,3,46001,80
29047,MO,"Clay County, MO",136610,132701,3909,3,70705,123
29049,MO,"Clinton County, MO",10738,10414,324,3,64541,113
29051,MO,"Cole County, MO",39051,38037,1014,4,61847,108
29053,MO,"Cooper County, MO",7481,7205,276,4,56957,99
29055,MO,"Crawford County, MO",10980,10566,414,3,48315,84
29057,MO,"Dade County, MO",3545,3434,111,5,42421,74
29059,MO,"Dallas County, MO",7081,6762,319,3,42389,74
29061,MO,"Daviess County, MO",4102,3965,137,3,48197,84
29063,MO,"DeKalb County, MO",4838,4689,149,4,53997,94
29065,MO,"Dent County, MO",6269,6044,225,5,45540,79
29067,MO,"Douglas County, MO",5107,4849,258,6,39773,69
29069,MO,"Dunklin County, MO",11598,10956,642,3,38880,68
29071,MO,"Franklin County, MO",53226,51511,1715,3,61428,107
29073,MO,"Gasconade County, MO",7732,7470,262,3,53751,94
29075,MO,"Gentry County, MO",3529,3433,96,3,53663,94
29077,MO,"Greene County, MO",151535,147461,4074,4,45313,79
29079,MO,"Grundy County, MO",4394,4240,154,3,44323,77
29081,MO,"Harrison County, MO",3822,3695,127,4,43016,75
29083,MO,"Henry County, MO",9728,9364,364,4,46995,82
29085,MO,"Hickory County, MO",3842,3681,161,3,32934,57
29087,MO,"Holt County, MO",2588,2515,73,3,47429,83
29089,MO,"Howard County, MO",4898,4746,152,4,49923,87
29091,MO,"Howell County, MO",16541,15870,671,5,40177,70
29093,MO,"Iron County, MO",3534,3365,169,4,39292,69
29095,MO,"Jackson County, MO",363539,350008,13531,3,57907,101
29097,MO,"Jasper County, MO",57304,55590,1714,3,46021,80
29099,MO,"Jefferson County, MO",118177,114498,3679,4,68779,120
29101,MO,"Johnson County, MO",23105,22247,858,3,58396,102
29103,MO,"Knox County, MO",1772,1720,52,7,41755,73
29105,MO,"Laclede County, MO",17386,16190,1196,3,43969,77
29107,MO,"Lafayette County, MO",16847,16328,519,4,62264,109
29109,MO,"Lawrence County, MO",18018,17385,633,3,45746,80
29111,MO,"Lewis County, MO",5003,4843,160,3,40782,71
29113,MO,"Lincoln County, MO",28448,27497,951,5,69178,121
29115,MO,"Linn County, MO",5124,4875,249,3,45774,80
29117,MO,"Livingston County, MO",7357,7170,187,3,49065,86
29119,MO,"McDonald County, MO",10690,10334,356,3,39615,69
29121,MO,"Macon County, MO",7535,7280,255,3,45717,80
29123,MO,"Madison County, MO",5484,5295,189,4,43919,77
29125,MO,"Maries County, MO",3884,3747,137,3,49712,87
29127,MO,"Marion County, MO",14565,14104,461,3,50803,89
29129,MO,"Mercer County, MO",1861,1802,59,4,44343,77
29131,MO,"Miller County, MO",12313,11850,463,4,49252,86
29133,MO,"Mississippi County, MO",5792,5555,237,3,36802,64
29135,MO,"Moniteau County, MO",7313,7097,216,4,57321,100
29137,MO,"Monroe County, MO",3872,3711,161,3,48399,84
29139,MO,"Montgomery County, MO",5738,5558,180,4,50282,88
29141,MO,"Morgan County, MO",8127,7776,351,4,44473,78
29143,MO,"New Madrid County, MO",8236,7880,356,3,42115,73
29145,MO,"Newton County, MO",27392,26498,894,3,53251,93
29147,MO,"Nodaway County, MO",10790,10468,322,4,47419,83
29149,MO,"Oregon County, MO",3981,3824,157,2,35356,62
29151,MO,"Osage County, MO",7106,6936,170,6,60728,106
29153,MO,"Ozark County, MO",3412,3214,198,5,36019,63
29155,MO,"Pemiscot County, MO",6364,6043,321,3,34280,60
29157,MO,"Perry County, MO",10065,9801,264,4,57032,99
29159,MO,"Pettis County, MO",20971,20227,744,3,48516,85
29161,MO,"Phelps County, MO",19828,19177,651,4,46573,81
29163,MO,"Pike County, MO",7492,7224,268,3,49089,86
29165,MO,"Platte County, MO",58805,57239,1566,3,84456,147
29167,MO,"Polk County, MO",14584,14081,503,4,44837,78
29169,MO,"Pulaski County, MO",14692,14094,598,4,55620,97
29171,MO,"Putnam County, MO",2291,2207,84,3,42434,74
29173,MO,"Ralls County, MO",5662,5484,178,4,63419,111
29175,MO,"Randolph County, MO",10380,9978,402,4,48043,84
29177,MO,"Ray County, MO",11033,10632,401,4,61678,108
29179,MO,"Reynolds County, MO",3042,2929,113,6,37415,65
29181,MO,"Ripley County, MO",5039,4761,278,3,35788,62
29183,MO,"St. Charles County, MO",227085,221305,5780,5,89236,156
29185,MO,"St. Clair County, MO",3749,3577,172,3,39319,69
29186,MO,"Ste. Genevieve County, MO",9197,8950,247,4,61662,108
29187,MO,"St. Francois County, MO",26637,25658,979,3,43886,77
29189,MO,"St. Louis County, MO",533085,516722,16363,3,70161,122
29195,MO,"Saline County, MO",10608,10267,341,4,47324,83
29197,MO,"Schuyler County, MO",1948,1862,86,3,43183,75
29199,MO,"Scotland County, MO",2384,2311,73,4,46871,82
29201,MO,"Scott County, MO",20000,19293,707,6,44924,78
29203,MO,"Shannon County, MO",3228,3048,180,3,36477,64
29205,MO,"Shelby County, MO",3061,2970,91,5,45939,80
29207,MO,"Stoddard County, MO",13098,12480,618,5,42363,74
29209,MO,"Stone County, MO",13873,13185,688,4,50262,88
29211,MO,"Sullivan County, MO",2684,2589,95,5,43421,76
29213,MO,"Taney County, MO",27142,25753,1389,5,49314,86
29215,MO,"Texas County, MO",9009,8607,402,4,38914,68
29217,MO,"Vernon County, MO",9466,9133,333,3,46182,81
29219,MO,"Warren County, MO",17971,17446,525,5,63726,111
29221,MO,"Washington County, MO",10241,9780,461,5,41198,72
29223,MO,"Wayne County, MO",5306,5050,256,4,35397,62
29225,MO,"Webster County, MO",17309,16692,617,3,54844,96
29227,MO,"Worth County, MO",1169,1138,31,5,45023,79
29229,MO,"Wright County, MO",7495,7101,394,4,39384,69
29510,MO,"St. Louis city, MO",153066,147111,5955,4,46309,81
30001,MT,"Beaverhead County, MT",5071,4922,149,7,49771,87
30003,MT,"Big Horn County, MT",4832,4475,357,4,43718,76
30005,MT,"Blaine County, MT",2487,2399,88,4,44090,77
30007,MT,"Broadwater County, MT",2585,2482,103,3,60622,106
30009,MT,"Carbon County, MT",5482,5293,189,3,57585,101
30011,MT,"Carter County, MT",644,626,18,3,49057,86
30013,MT,"Cascade County, MT",37939,36651,1288,3,51732,90
30015,MT,"Chouteau County, MT",2455,2389,66,3,48017,84
30017,MT,"Custer County, MT",6060,5886,174,2,49379,86
30019,MT,"Daniels County, MT",893,875,18,2,50001,87
30021,MT,"Dawson County, MT",4578,4467,111,3,56677,99
30023,MT,"Deer Lodge County, MT",5038,4877,161,2,41780,73
30025,MT,"Fallon County, MT",1704,1674,30,3,65651,115
30027,MT,"Fergus County, MT",6044,5856,188,5,48703,85
30029,MT,"Flathead County, MT",47892,45646,2246,2,61334,107
30031,MT,"Gallatin County, MT",68760,67205,1555,2,73731,129
30033,MT,"Garfield County, MT",738,720,18,8,43106,75
30035,MT,"Glacier County, MT",5693,5266,427,4,41808,73
30037,MT,"Golden Valley County, MT",367,352,15,6,40469,71
30039,MT,"Granite County, MT",1687,1591,96,4,49646,87
30041,MT,"Hill County, MT",7641,7360,281,3,51881,91
30043,MT,"Jefferson County, MT",5698,5509,189,3,70929,124
30045,MT,"Judith Basin County, MT",948,919,29,4,49401,86
30047,MT,"Lake County, MT",13201,12644,557,3,49019,86
30049,MT,"Lewis and Clark County, MT",35824,34759,1065,3,66075,115
30051,MT,"Liberty County, MT",953,929,24,7,41240,72
30053,MT,"Lincoln County, MT",8085,7499,586,2,43669,76
30055,MT,"McCone County, MT",951,932,19,3,48551,85
30057,MT,"Madison County, MT",4808,4654,154,4,56579,99
30059,MT,"Meagher County, MT",955,922,33,6,43946,77
30061,MT,"Mineral County, MT",1757,1657,100,3,43928,77
30063,MT,"Missoula County, MT",63825,61776,2049,4,57279,100
30065,MT,"Musselshell County, MT",2265,2177,88,3,48290,84
30067,MT,"Park County, MT",8911,8606,305,4,51740,90
30069,MT,"Petroleum County, MT",279,269,10,4,42081,74
30071,MT,"Phillips County, MT",1883,1813,70,4,47679,83
30073,MT,"Pondera County, MT",2671,2570,101,2,48542,85
30075,MT,"Powder River County, MT",959,936,23,4,47843,84
30077,MT,"Powell County, MT",2973,2865,108,4,49387,86
30079,MT,"Prairie County, MT",477,459,18,4,46663,82
30081,MT,"Ravalli County, MT",20230,19411,819,3,57209,100
30083,MT,"Richland County, MT",5880,5724,156,4,69095,121
30085,MT,"Roosevelt County, MT",4502,4308,194,5,38409,67
30087,MT,"Rosebud County, MT",3827,3635,192,6,58139,102
30089,MT,"Sanders County, MT",4844,4559,285,2,45193,79
30091,MT,"Sheridan County, MT",1741,1702,39,4,51111,89
30093,MT,"Silver Bow County, MT",17191,16542,649,3,49249,86
30095,MT,"Stillwater County, MT",5180,5018,162,3,68186,119
30097,MT,"Sweet Grass County, MT",1798,1748,50,3,55259,97
30099,MT,"Teton County, MT",2740,2650,90,2,54458,95
30101,MT,"Toole County, MT",2115,2064,51,3,49448,86
30103,MT,"Treasure County, MT",334,325,9,3,51754,90
30105,MT,"Valley County, MT",4079,3950,129,4,51869,91
30107,MT,"Wheatland County, MT",785,755,30,3,42059,74
30109,MT,"Wibaux County, MT",463,449,14,3,51145,89
30111,MT,"Yellowstone County, MT",81781,79173,2608,3,61435,107
31001,NE,"Adams County, NE",16792,16262,530,3,55182,87
31003,NE,"Antelope County, NE",3558,3467,91,5,50771,80
31005,NE,"Arthur County, NE",224,212,12,4,46417,73
31007,NE,"Banner County, NE",377,363,14,5,54706,86
31009,NE,"Blaine County, NE",259,246,13,3,45411,72
31011,NE,"Boone County, NE",2963,2882,81,3,58204,92
31013,NE,"Box Butte County, NE",5419,5247,172,3,61522,97
31015,NE,"Boyd County, NE",1078,1042,36,4,46548,74
31017,NE,"Brown County, NE",1393,1344,49,3,48843,77
31019,NE,"Buffalo County, NE",27777,27048,729,3,64759,102
31021,NE,"Burt County, NE",3483,3366,117,3,54554,86
31023,NE,"Butler County, NE",4591,4472,119,3,63310,100
31025,NE,"Cass County, NE",13570,13117,453,3,72915,115
31027,NE,"Cedar County, NE",4515,4402,113,2,60400,95
31029,NE,"Chase County, NE",2277,2225,52,2,57656,91
31031,NE,"Cherry County, NE",3389,3308,81,4,50677,80
31033,NE,"Cheyenne County, NE",4416,4253,163,3,56229,89
31035,NE,"Clay County, NE",3298,3192,106,3,63829,101
31037,NE,"Colfax County, NE",5581,5429,152,3,62472,99
31039,NE,"Cuming County, NE",4696,4571,125,2,59505,94
31041,NE,"Custer County, NE",6416,6261,155,4,51004,81
31043,NE,"Dakota County, NE",10791,10369,422,3,61010,96
31045,NE,"Dawes County, NE",4978,4832,146,3,46377,73
31047,NE,"Dawson County, NE",13056,12667,389,3,56839,90
31049,NE,"Deuel County, NE",957,929,28,3,48793,77
31051,NE,"Dixon County, NE",3034,2941,93,3,57324,91
31053,NE,"Dodge County, NE",19501,18931,570,3,60853,96
31055,NE,"Douglas County, NE",299587,289816,9771,3,67264,106
31057,NE,"Dundy County, NE",1171,1141,30,3,45446,72
31059,NE,"Fillmore County, NE",3162,3080,82,3,60440,96
31061,NE,"Franklin County, NE",1459,1409,50,3,49659,79
31063,NE,"Frontier County, NE",1613,1560,53,3,55712,88
31065,NE,"Furnas County, NE",2583,2511,72,4,50705,80
31067,NE,"Gage County, NE",11010,10619,391,3,56817,90
31069,NE,"Garden County, NE",1103,1071,32,3,41158,65
31071,NE,"Garfield County, NE",1168,1137,31,3,52707,83
31073,NE,"Gosper County, NE",1109,1080,29,3,64870,103
31075,NE,"Grant County, NE",424,412,12,3,60773,96
31077,NE,"Greeley County, NE",1222,1186,36,4,48178,76
31079,NE,"Hall County, NE",31903,30801,1102,3,57371,91
31081,NE,"Hamilton County, NE",4769,4624,145,3,68236,108
31083,NE,"Harlan County, NE",1796,1745,51,2,53362,84
31085,NE,"Hayes County, NE",613,598,15,3,46399,73
31087,NE,"Hitchcock County, NE",1266,1223,43,3,49451,78
31089,NE,"Holt County, NE",5763,5613,150,3,54474,86
31091,NE,"Hooker County, NE",417,404,13,4,50093,79
31093,NE,"Howard County, NE",3365,3247,118,3,56881,90
31095,NE,"Jefferson County, NE",4143,4030,113,4,56740,90
31097,NE,"Johnson County, NE",2064,1992,72,2,54567,86
31099,NE,"Kearney County, NE",3791,3705,86,3,64461,102
31101,NE,"Keith County, NE",4592,4444,148,3,51478,81
31103,NE,"Keya Paha County, NE",589,574,15,3,46010,73
31105,NE,"Kimball County, NE",2031,1970,61,3,52284,83
31107,NE,"Knox County, NE",4611,4473,138,3,53676,85
31109,NE,"Lancaster County, NE",177186,172276,4910,4,61383,97
31111,NE,"Lincoln County, NE",18327,17689,638,3,60924,96
31113,NE,"Logan County, NE",473,459,14,4,53108,84
31115,NE,"Loup County, NE",405,389,16,3,51559,82
31117,NE,"McPherson County, NE",443,431,12,3,52033,82
31119,NE,"Madison County, NE",19816,19258,558,3,58275,92
31121,NE,"Merrick County, NE",4013,3885,128,3,53411,84
31123,NE,"Morrill County, NE",2607,2532,75,3,49982,79
31125,NE,"Nance County, NE",1976,1917,59,4,55853,88
31127,NE,"Nemaha County, NE",3603,3471,132,3,55343,87
31129,NE,"Nuckolls County, NE",2404,2340,64,3,48624,77
31131,NE,"Otoe County, NE",8429,8159,270,3,66293,105
31133,NE,"Pawnee County, NE",1478,1435,43,2,47006,74
31135,NE,"Perkins County, NE",1821,1779,42,3,63443,100
31137,NE,"Phelps County, NE",4969,4838,131,3,61420,97
31139,NE,"Pierce County, NE",4095,3985,110,3,67465,107
31141,NE,"Platte County, NE",17668,17153,515,3,62804,99
31143,NE,"Polk County, NE",2931,2850,81,3,66462,105
31145,NE,"Red Willow County, NE",5850,5689,161,3,50260,79
31147,NE,"Richardson County, NE",4238,4103,135,3,50207,79
31149,NE,"Rock County, NE",871,844,27,3,53905,85
31151,NE,"Saline County, NE",7372,7133,239,3,59937,95
31153,NE,"Sarpy County, NE",96599,93801,2798,3,84016,133
31155,NE,"Saunders County, NE",11169,10858,311,4,71086,112
31157,NE,"Scotts Bluff County, NE",18287,17614,673,3,50263,79
31159,NE,"Seward County, NE",8931,8669,262,3,72291,114
31161,NE,"Sheridan County, NE",2673,2599,74,3,46159,73
31163,NE,"Sherman County, NE",1691,1637,54,3,48735,77
31165,NE,"Sioux County, NE",746,725,21,3,47983,76
31167,NE,"Stanton County, NE",3507,3416,91,3,62045,98
31169,NE,"Thayer County, NE",2787,2713,74,4,52439,83
31171,NE,"Thomas County, NE",423,408,15,5,51401,81
31173,NE,"Thurston County, NE",3058,2920,138,3,48891,77
31175,NE,"Valley County, NE",2125,2057,68,3,47981,76
31177,NE,"Washington County, NE",11279,10950,329,3,75197,119
31179,NE,"Wayne County, NE",5749,5599,150,4,57655,91
31181,NE,"Webster County, NE",1678,1619,59,3,49518,78
31183,NE,"Wheeler County, NE",572,556,16,3,50207,79
31185,NE,"York County, NE",7278,7083,195,4,59749,94
32001,NV,"Churchill County, NV",11057,10666,391,4,56335,89
32003,NV,"Clark County, NV",1131551,1085793,45758,4,62131,98
32005,NV,"Douglas County, NV",23210,22300,910,3,76296,121
32007,NV,"Elko County, NV",27362,26549,813,4,83287,132
32009,NV,"Esmeralda County, NV",434,418,16,2,50675,80
32011,NV,"Eureka County, NV",1095,1069,26,3,71541,113
32013,NV,"Humboldt County, NV",8251,8009,242,3,73106,116
32015,NV,"Lander County, NV",3214,3112,102,4,81239,128
32017,NV,"Lincoln County, NV",2113,2029,84,5,58782,93
32019,NV,"Lyon County, NV",23407,22309,1098,4,59406,94
32021,NV,"Mineral County, NV",2030,1948,82,5,43771,69
32023,NV,"Nye County, NV",17297,16415,882,4,48490,77
32027,NV,"Pershing County, NV",2563,2460,103,4,58562,93
32029,NV,"Storey County, NV",2038,1962,76,3,88003,139
32031,NV,"Washoe County, NV",255915,247691,8224,3,71733,113
32033,NV,"White Pine County, NV",4636,4499,137,4,60086,95
32510,NV,"Carson City, NV",26282,25248,1034,3,58126,92
33001,NH,"Belknap County, NH",31583,30787,796,3,68752,88
33003,NH,"Carroll County, NH",23974,23366,608,3,64495,82
33005,NH,"Cheshire County, NH",40926,39856,1070,3,65326,83
33007,NH,"Coos County, NH",14741,14273,468,2,49156,63
33009,NH,"Grafton County, NH",49880,48784,1096,3,62468,80
33011,NH,"Hillsborough County, NH",242579,236216,6363,2,82862,106
33013,NH,"Merrimack County, NH",83845,81955,1890,3,75800,97
33015,NH,"Rockingham County, NH",188440,183326,5114,2,91416,116
33017,NH,"Strafford County, NH",74621,72875,1746,2,71486,91
33019,NH,"Sullivan County, NH",23145,22616,529,4,63518,81
34001,NJ,"Atlantic County, NJ",120728,114622,6106,3,62678,73
34003,NJ,"Bergen County, NJ",482038,467946,14092,3,107971,126
34005,NJ,"Burlington County, NJ",230589,223049,7540,4,88443,103
34007,NJ,"Camden County, NJ",253053,242811,10242,7,73168,85
34009,NJ,"Cape May County, NJ",45947,42660,3287,6,66565,78
34011,NJ,"Cumberland County, NJ",65061,61481,3580,5,54179,63
34013,NJ,"Essex County, NJ",368748,352334,16414,4,64522,75
34015,NJ,"Gloucester County, NJ",149747,144238,5509,3,87996,103
34017,NJ,"Hudson County, NJ",361189,349372,11817,3,77738,91
34019,NJ,"Hunterdon County, NJ",64523,62742,1781,3,117275,137
34021,NJ,"Mercer County, NJ",202885,196458,6427,3,79475,93
34023,NJ,"Middlesex County, NJ",439073,425471,13602,3,92770,108
34025,NJ,"Monmouth County, NJ",328661,318233,10428,3,102579,120
34027,NJ,"Morris County, NJ",256698,249463,7235,4,116328,136
34029,NJ,"Ocean County, NJ",275023,264876,10147,4,75627,88
34031,NJ,"Passaic County, NJ",242208,231779,10429,5,76039,89
34033,NJ,"Salem County, NJ",29180,27771,1409,3,68146,79
34035,NJ,"Somerset County, NJ",171371,166229,5142,3,112722,131
34037,NJ,"Sussex County, NJ",73963,71425,2538,4,100281,117
34039,NJ,"Union County, NJ",276382,266189,10193,3,79953,93
34041,NJ,"Warren County, NJ",56060,54185,1875,5,83998,98
35001,NM,"Bernalillo County, NM",333865,319048,14817,6,56148,108
35003,NM,"Catron County, NM",1153,1081,72,5,37190,72
35005,NM,"Chaves County, NM",27165,25839,1326,6,43687,84
35006,NM,"Cibola County, NM",8991,8425,566,5,40436,78
35007,NM,"Colfax County, NM",5483,5226,257,4,42754,82
35009,NM,"Curry County, NM",21680,20783,897,4,45623,88
35011,NM,"De Baca County, NM",795,761,34,6,34746,67
35013,NM,"Dona Ana County, NM",97527,91976,5551,3,43618,84
35015,NM,"Eddy County, NM",34483,33419,1064,5,63671,122
35017,NM,"Grant County, NM",12228,11639,589,5,43175,83
35019,NM,"Guadalupe County, NM",1549,1467,82,5,36554,70
35021,NM,"Harding County, NM",273,259,14,4,38162,73
35023,NM,"Hidalgo County, NM",2091,2002,89,4,37322,72
35025,NM,"Lea County, NM",31282,30054,1228,5,63012,121
35027,NM,"Lincoln County, NM",8984,8570,414,3,47254,91
35028,NM,"Los Alamos County, NM",9463,9163,300,12,122001,235
35029,NM,"Luna County, NM",10309,9047,1262,7,32544,63
35031,NM,"McKinley County, NM",24155,22458,1697,6,36404,70
35033,NM,"Mora County, NM",2213,2080,133,5,36968,71
35035,NM,"Otero County, NM",24798,23575,1223,5,43135,83
35037,NM,"Quay County, NM",3229,3062,167,5,34596,67
35039,NM,"Rio Arriba County, NM",16835,15951,884,5,44579,86
35041,NM,"Roosevelt County, NM",7901,7545,356,5,44928,86
35043,NM,"Sandoval County, NM",66475,63268,3207,6,71118,137
35045,NM,"San Juan County, NM",51941,48974,2967,6,46201,89
35047,NM,"San Miguel County, NM",10809,10177,632,4,36986,71
35049,NM,"Santa Fe County, NM",75116,72153,2963,7,61791,119
35051,NM,"Sierra County, NM",3893,3628,265,6,33661,65
35053,NM,"Socorro County, NM",6446,6071,375,6,39582,76
35055,NM,"Taos County, NM",15218,14303,915,7,43032,83
35057,NM,"Torrance County, NM",5699,5312,387,4,39532,76
35059,NM,"Union County, NM",1846,1781,65,5,38221,74
35061,NM,"Valencia County, NM",30710,29074,1636,4,54867,106
36001,NY,"Albany County, NY",157444,151699,5745,6,69408,96
36003,NY,"Allegany County, NY",19441,18380,1061,5,49411,69
36005,NY,"Bronx County, NY",597677,565642,32035,5,41470,58
36007,NY,"Broome County, NY",83444,79488,3956,5,52179,72
36009,NY,"Cattaraugus County, NY",33884,32172,1712,4,50783,71
36011,NY,"Cayuga County, NY",35952,34411,1541,5,58055,81
36013,NY,"Chautauqua County, NY",54550,51976,2574,4,50143,70
36015,NY,"Chemung County, NY",35019,33543,1476,4,58400,81
36017,NY,"Chenango County, NY",22080,21098,982,4,51894,72
36019,NY,"Clinton County, NY",36302,34720,1582,3,59069,82
36021,NY,"Columbia County, NY",31181,30176,1005,5,71563,99
36023,NY,"Cortland County, NY",22853,21735,1118,5,55143,77
36025,NY,"Delaware County, NY",19117,18216,901,4,51038,71
36027,NY,"Dutchess County, NY",144040,138841,5199,4,84564,117
36029,NY,"Erie County, NY",441291,422508,18783,5,60620,84
36031,NY,"Essex County, NY",16995,16190,805,5,55091,77
36033,NY,"Franklin County, NY",19614,18648,966,5,48943,68
36035,NY,"Fulton County, NY",22656,21517,1139,4,50061,70
36037,NY,"Genesee County, NY",29736,28564,1172,5,62570,87
36039,NY,"Greene County, NY",20271,19358,913,6,54746,76
36041,NY,"Hamilton County, NY",2214,2081,133,5,60148,84
36043,NY,"Herkimer County, NY",27932,26560,1372,6,55778,77
36045,NY,"Jefferson County, NY",43941,41470,2471,4,53829,75
36047,NY,"Kings County, NY",1198160,1149461,48699,6,66501,92
36049,NY,"Lewis County, NY",11644,10999,645,4,56599,79
36051,NY,"Livingston County, NY",30726,29423,1303,5,60268,84
36053,NY,"Madison County, NY",32766,31296,1470,4,61713,86
36055,NY,"Monroe County, NY",361254,346207,15047,5,62159,86
36057,NY,"Montgomery County, NY",22306,21173,1133,3,52092,72
36059,NY,"Nassau County, NY",708118,683726,24392,4,117767,164
36061,NY,"New York County, NY",911638,879665,31973,5,93007,129
36063,NY,"Niagara County, NY",98786,93887,4899,4,56371,78
36065,NY,"Oneida County, NY",101170,96839,4331,4,56516,79
36067,NY,"Onondaga County, NY",220549,211875,8674,4,61597,86
36069,NY,"Ontario County, NY",55362,53210,2152,4,66754,93
36071,NY,"Orange County, NY",184985,177952,7033,5,83188,116
36073,NY,"Orleans County, NY",17567,16740,827,5,53115,74
36075,NY,"Oswego County, NY",52960,50082,2878,4,57640,80
36077,NY,"Otsego County, NY",28060,26876,1184,4,52414,73
36079,NY,"Putnam County, NY",51230,49336,1894,4,105600,147
36081,NY,"Queens County, NY",1139397,1099996,39401,4,72975,101
36083,NY,"Rensselaer County, NY",81089,78030,3059,4,70688,98
36085,NY,"Richmond County, NY",222319,213734,8585,4,86624,120
36087,NY,"Rockland County, NY",155237,149705,5532,6,99831,139
36089,NY,"St. Lawrence County, NY",43294,40902,2392,3,51742,72
36091,NY,"Saratoga County, NY",118925,114903,4022,4,89071,124
36093,NY,"Schenectady County, NY",76028,73106,2922,5,64960,90
36095,NY,"Schoharie County, NY",14637,13954,683,5,58927,82
36097,NY,"Schuyler County, NY",8085,7709,376,4,52215,73
36099,NY,"Seneca County, NY",16027,15414,613,5,51064,71
36101,NY,"Steuben County, NY",42520,40572,1948,4,53167,74
36103,NY,"Suffolk County, NY",778193,749347,28846,4,105241,146
36105,NY,"Sullivan County, NY",36653,35205,1448,4,58851,82
36107,NY,"Tioga County, NY",22687,21746,941,4,60699,84
36109,NY,"Tompkins County, NY",49361,47567,1794,4,59176,82
36111,NY,"Ulster County, NY",87692,84387,3305,5,64090,89
36113,NY,"Warren County, NY",31299,29868,1431,4,63240,88
36115,NY,"Washington County, NY",27831,26698,1133,4,56897,79
36117,NY,"Wayne County, NY",43835,42070,1765,4,61989,86
36119,NY,"Westchester County, NY",484382,466158,18224,4,101741,141
36121,NY,"Wyoming County, NY",18131,17336,795,4,58214,81
36123,NY,"Yates County, NY",11849,11407,442,4,60612,84
37001,NC,"Alamance County, NC",82597,79459,3138,3,57963,101
37003,NC,"Alexander County, NC",18159,17557,602,5,54960,96
37005,NC,"Alleghany County, NC",4415,4205,210,4,41420,72
37007,NC,"Anson County, NC",10834,10381,453,4,40826,71
37009,NC,"Ashe County, NC",12908,12429,479,4,41542,72
37011,NC,"Avery County, NC",7502,7221,281,5,45823,80
37013,NC,"Beaufort County, NC",19578,18672,906,5,49410,86
37015,NC,"Bertie County, NC",7822,7448,374,5,37899,66
37017,NC,"Bladen County, NC",14629,13923,706,5,42260,74
37019,NC,"Brunswick County, NC",54411,51599,2812,3,63712,111
37021,NC,"Buncombe County, NC",141959,137723,4236,4,55448,97
37023,NC,"Burke County, NC",41324,39785,1539,4,47890,83
37025,NC,"Cabarrus County, NC",109927,106011,3916,4,72071,126
37027,NC,"Caldwell County, NC",36866,35370,1496,4,48512,85
37029,NC,"Camden County, NC",4661,4481,180,4,69610,121
37031,NC,"Carteret County, NC",32229,30889,1340,5,60058,105
37033,NC,"Caswell County, NC",9924,9477,447,4,51240,89
37035,NC,"Catawba County, NC",79540,76686,2854,3,53688,94
37037,NC,"Chatham County, NC",35910,34695,1215,5,70258,122
37039,NC,"Cherokee County, NC",11226,10724,502,5,42764,75
37041,NC,"Chowan County, NC",5560,5298,262,5,47126,82
37043,NC,"Clay County, NC",4148,3960,188,4,47116,82
37045,NC,"Cleveland County, NC",48738,46793,1945,5,46012,80
37047,NC,"Columbus County, NC",22941,21811,1130,4,39531,69
37049,NC,"Craven County, NC",42150,40431,1719,5,53372,93
37051,NC,"Cumberland County, NC",128856,122306,6550,4,46599,81
37053,NC,"Currituck County, NC",14117,13609,508,5,70699,123
37055,NC,"Dare County, NC",20063,19116,947,4,63033,110
37057,NC,"Davidson County, NC",81755,78747,3008,3,53924,94
37059,NC,"Davie County, NC",20873,20161,712,4,63828,111
37061,NC,"Duplin County, NC",25424,24394,1030,3,44929,78
37063,NC,"Durham County, NC",172359,166460,5899,6,65541,114
37065,NC,"Edgecombe County, NC",21439,20179,1260,4,40784,71
37067,NC,"Forsyth County, NC",189793,182709,7084,4,53054,92
37069,NC,"Franklin County, NC",31571,30309,1262,4,57371,100
37071,NC,"Gaston County, NC",111967,107634,4333,4,56542,99
37073,NC,"Gates County, NC",5363,5145,218,5,54204,95
37075,NC,"Graham County, NC",3256,3080,176,3,45813,80
37077,NC,"Granville County, NC",30243,29219,1024,4,54300,95
37079,NC,"Greene County, NC",9577,9215,362,4,44648,78
37081,NC,"Guilford County, NC",265349,254504,10845,6,55820,97
37083,NC,"Halifax County, NC",20501,19326,1175,5,38727,68
37085,NC,"Harnett County, NC",53705,51237,2468,3,55619,97
37087,NC,"Haywood County, NC",30282,29255,1027,3,51612,90
37089,NC,"Henderson County, NC",55704,53865,1839,5,61651,107
37091,NC,"Hertford County, NC",9225,8746,479,5,42374,74
37093,NC,"Hoke County, NC",20307,19304,1003,9,48420,84
37095,NC,"Hyde County, NC",1977,1807,170,4,43112,75
37097,NC,"Iredell County, NC",90208,86966,3242,4,68308,119
37099,NC,"Jackson County, NC",19957,19130,827,4,47759,83
37101,NC,"Johnston County, NC",99974,96347,3627,4,62835,110
37103,NC,"Jones County, NC",4436,4264,172,5,46275,81
37105,NC,"Lee County, NC",26174,24995,1179,4,53114,93
37107,NC,"Lenoir County, NC",28078,27012,1066,4,39947,70
37109,NC,"Lincoln County, NC",43826,42284,1542,4,70479,123
37111,NC,"McDowell County, NC",20877,20075,802,4,46370,81
37113,NC,"Macon County, NC",15637,15027,610,4,46279,81
37115,NC,"Madison County, NC",10283,9909,374,5,50062,87
37117,NC,"Martin County, NC",9093,8630,463,4,39413,69
37119,NC,"Mecklenburg County, NC",626769,603983,22786,5,69455,121
37121,NC,"Mitchell County, NC",6073,5792,281,4,47675,83
37123,NC,"Montgomery County, NC",11606,11143,463,4,46497,81
37125,NC,"Moore County, NC",42887,41263,1624,5,63942,111
37127,NC,"Nash County, NC",43610,41511,2099,4,50902,89
37129,NC,"New Hanover County, NC",125131,120673,4458,5,57252,100
37131,NC,"Northampton County, NC",7792,7386,406,5,39777,69
37133,NC,"Onslow County, NC",65413,62388,3025,3,50645,88
37135,NC,"Orange County, NC",79385,76782,2603,4,74314,130
37137,NC,"Pamlico County, NC",5391,5186,205,5,52522,92
37139,NC,"Pasquotank County, NC",16794,16021,773,4,51245,89
37141,NC,"Pender County, NC",29150,28001,1149,5,60405,105
37143,NC,"Perquimans County, NC",4992,4741,251,4,50804,89
37145,NC,"Person County, NC",18571,17790,781,4,54553,95
37147,NC,"Pitt County, NC",90556,86710,3846,4,52961,92
37149,NC,"Polk County, NC",9094,8748,346,4,53405,93
37151,NC,"Randolph County, NC",66978,64451,2527,5,50129,87
37153,NC,"Richmond County, NC",16727,15844,883,5,40518,71
37155,NC,"Robeson County, NC",50481,47748,2733,4,36366,63
37157,NC,"Rockingham County, NC",40573,38791,1782,4,44686,78
37159,NC,"Rowan County, NC",66751,64079,2672,5,52051,91
37161,NC,"Rutherford County, NC",25376,24131,1245,4,44547,78
37163,NC,"Sampson County, NC",29437,28301,1136,7,45997,80
37165,NC,"Scotland County, NC",11599,10832,767,4,39197,68
37167,NC,"Stanly County, NC",30438,29309,1129,4,58303,102
37169,NC,"Stokes County, NC",21936,21149,787,4,52356,91
37171,NC,"Surry County, NC",34200,32947,1253,4,48637,85
37173,NC,"Swain County, NC",7018,6737,281,4,46075,80
37175,NC,"Transylvania County, NC",14747,14196,551,6,55628,97
37177,NC,"Tyrrell County, NC",1484,1396,88,4,37680,66
37179,NC,"Union County, NC",124843,120533,4310,6,86138,150
37181,NC,"Vance County, NC",17501,16488,1013,3,40450,71
37183,NC,"Wake County, NC",600826,580731,20095,6,84377,147
37185,NC,"Warren County, NC",6638,6260,378,6,37027,65
37187,NC,"Washington County, NC",4492,4229,263,4,40157,70
37189,NC,"Watauga County, NC",29679,28640,1039,4,51630,90
37191,NC,"Wayne County, NC",52394,50225,2169,4,45634,80
37193,NC,"Wilkes County, NC",29489,28292,1197,6,45250,79
37195,NC,"Wilson County, NC",35026,33002,2024,3,42414,74
37197,NC,"Yadkin County, NC",17923,17307,616,4,50929,89
37199,NC,"Yancey County, NC",8466,8148,318,2,47664,83
38001,ND,"Adams County, ND",1046,1023,23,3,55880,83
38003,ND,"Barnes County, ND",5143,4987,156,4,60689,90
38005,ND,"Benson County, ND",2273,2177,96,3,45709,68
38007,ND,"Billings County, ND",430,419,11,3,69528,103
38009,ND,"Bottineau County, ND",2935,2838,97,2,62904,93
38011,ND,"Bowman County, ND",1714,1686,28,2,65411,97
38013,ND,"Burke County, ND",1053,1029,24,2,67545,100
38015,ND,"Burleigh County, ND",49216,48036,1180,2,73565,109
38017,ND,"Cass County, ND",102347,100269,2078,3,63977,95
38019,ND,"Cavalier County, ND",1882,1830,52,2,63484,94
38021,ND,"Dickey County, ND",2281,2238,43,1,57490,85
38023,ND,"Divide County, ND",1439,1419,20,2,61506,91
38025,ND,"Dunn County, ND",3153,3102,51,5,75723,112
38027,ND,"Eddy County, ND",1213,1159,54,4,54465,81
38029,ND,"Emmons County, ND",1428,1369,59,3,53073,79
38031,ND,"Foster County, ND",1497,1456,41,2,54917,82
38033,ND,"Golden Valley County, ND",830,815,15,2,58370,87
38035,ND,"Grand Forks County, ND",37105,36332,773,2,57388,85
38037,ND,"Grant County, ND",1179,1152,27,3,41841,62
38039,ND,"Griggs County, ND",1013,988,25,2,56527,84
38041,ND,"Hettinger County, ND",1361,1334,27,4,54600,81
38043,ND,"Kidder County, ND",1247,1197,50,2,50570,75
38045,ND,"LaMoure County, ND",2036,1993,43,2,56059,83
38047,ND,"Logan County, ND",860,840,20,4,51496,76
38049,ND,"McHenry County, ND",3030,2924,106,3,59661,89
38051,ND,"McIntosh County, ND",1104,1071,33,2,47349,70
38053,ND,"McKenzie County, ND",10298,10138,160,3,86890,129
38055,ND,"McLean County, ND",4663,4516,147,4,67453,100
38057,ND,"Mercer County, ND",3577,3427,150,3,83341,124
38059,ND,"Morton County, ND",16191,15713,478,1,68051,101
38061,ND,"Mountrail County, ND",7312,7211,101,3,69040,102
38063,ND,"Nelson County, ND",1373,1330,43,4,56098,83
38065,ND,"Oliver County, ND",861,829,32,4,72919,108
38067,ND,"Pembina County, ND",3303,3189,114,3,59970,89
38069,ND,"Pierce County, ND",1706,1651,55,3,56753,84
38071,ND,"Ramsey County, ND",5551,5388,163,2,60710,90
38073,ND,"Ransom County, ND",2789,2741,48,3,66422,99
38075,ND,"Renville County, ND",1203,1173,30,2,84986,126
38077,ND,"Richland County, ND",8530,8330,200,8,62837,93
38079,ND,"Rolette County, ND",4568,4192,376,2,45296,67
38081,ND,"Sargent County, ND",2634,2587,47,4,67551,100
38083,ND,"Sheridan County, ND",671,642,29,4,58725,87
38085,ND,"Sioux County, ND",1233,1185,48,2,37133,55
38087,ND,"Slope County, ND",393,384,9,2,52695,78
38089,ND,"Stark County, ND",18461,18087,374,2,68759,102
38091,ND,"Steele County, ND",967,947,20,2,67661,100
38093,ND,"Stutsman County, ND",10224,9989,235,3,60297,90
38095,ND,"Towner County, ND",1121,1090,31,3,53024,79
38097,ND,"Traill County, ND",4338,4224,114,3,69443,103
38099,ND,"Walsh County, ND",5109,4942,167,3,59153,88
38101,ND,"Ward County, ND",31394,30614,780,3,68634,102
38103,ND,"Wells County, ND",1890,1832,58,2,56167,83
38105,ND,"Williams County, ND",24427,23989,438,4,84606,126
39001,OH,"Adams County, OH",10717,9984,733,4,43145,74
39003,OH,"Allen County, OH",47866,45937,1929,4,58271,99
39005,OH,"Ashland County, OH",26801,25687,1114,5,52554,90
39007,OH,"Ashtabula County, OH",44459,42334,2125,5,47388,81
39009,OH,"Athens County, OH",27694,26226,1468,3,43621,74
39011,OH,"Auglaize County, OH",24980,24230,750,6,64227,109
39013,OH,"Belmont County, OH",30153,28469,1684,5,50166,86
39015,OH,"Brown County, OH",19594,18619,975,4,58441,100
39017,OH,"Butler County, OH",195091,187729,7362,5,68611,117
39019,OH,"Carroll County, OH",12959,12317,642,4,56999,97
39021,OH,"Champaign County, OH",20033,19295,738,4,62077,106
39023,OH,"Clark County, OH",63253,60520,2733,4,50832,87
39025,OH,"Clermont County, OH",106832,102846,3986,5,68724,117
39027,OH,"Clinton County, OH",17682,16849,833,5,52870,90
39029,OH,"Columbiana County, OH",47395,45105,2290,6,52693,90
39031,OH,"Coshocton County, OH",14377,13536,841,5,49679,85
39033,OH,"Crawford County, OH",18208,17356,852,4,49484,84
39035,OH,"Cuyahoga County, OH",614517,588912,25605,4,52503,89
39037,OH,"Darke County, OH",25812,24863,949,4,56824,97
39039,OH,"Defiance County, OH",18085,17322,763,3,60918,104
39041,OH,"Delaware County, OH",110349,106887,3462,5,110252,188
39043,OH,"Erie County, OH",37223,35383,1840,4,60790,104
39045,OH,"Fairfield County, OH",78021,75118,2903,4,71782,122
39047,OH,"Fayette County, OH",13869,13330,539,4,51023,87
39049,OH,"Franklin County, OH",697639,673069,24570,4,64648,110
39051,OH,"Fulton County, OH",22455,21526,929,5,64334,110
39053,OH,"Gallia County, OH",12158,11496,662,4,48094,82
39055,OH,"Geauga County, OH",49294,47586,1708,4,79865,136
39057,OH,"Greene County, OH",83246,80130,3116,6,69709,119
39059,OH,"Guernsey County, OH",18623,17607,1016,4,48283,82
39061,OH,"Hamilton County, OH",416102,400359,15743,3,60251,103
39063,OH,"Hancock County, OH",41849,40525,1324,4,62720,107
39065,OH,"Hardin County, OH",13812,13232,580,5,51155,87
39067,OH,"Harrison County, OH",6800,6443,357,5,50137,85
39069,OH,"Henry County, OH",13265,12654,611,5,61351,105
39071,OH,"Highland County, OH",17036,16155,881,5,47126,80
39073,OH,"Hocking County, OH",13084,12484,600,3,51016,87
39075,OH,"Holmes County, OH",20783,20160,623,6,62596,107
39077,OH,"Huron County, OH",27985,26381,1604,6,56704,97
39079,OH,"Jackson County, OH",12678,11891,787,6,50671,86
39081,OH,"Jefferson County, OH",27729,26101,1628,4,47652,81
39083,OH,"Knox County, OH",31550,30306,1244,4,59957,102
39085,OH,"Lake County, OH",126718,122045,4673,5,65040,111
39087,OH,"Lawrence County, OH",23780,22549,1231,4,46433,79
39089,OH,"Licking County, OH",90521,87159,3362,4,66321,113
39091,OH,"Logan County, OH",22865,22036,829,4,60624,103
39093,OH,"Lorain County, OH",154180,147587,6593,5,59201,101
39095,OH,"Lucas County, OH",210209,200417,9792,3,49924,85
39097,OH,"Madison County, OH",20804,20091,713,6,65696,112
39099,OH,"Mahoning County, OH",103081,97180,5901,4,48018,82
39101,OH,"Marion County, OH",28444,27292,1152,3,51479,88
39103,OH,"Medina County, OH",97857,94520,3337,7,78540,134
39105,OH,"Meigs County, OH",9057,8428,629,3,43754,75
39107,OH,"Mercer County, OH",23398,22787,611,4,67075,114
39109,OH,"Miami County, OH",54117,52125,1992,8,63524,108
39111,OH,"Monroe County, OH",5345,4903,442,4,48231,82
39113,OH,"Montgomery County, OH",252534,241945,10589,7,54704,93
39115,OH,"Morgan County, OH",6714,6280,434,4,46883,80
39117,OH,"Morrow County, OH",16815,16124,691,5,59498,101
39119,OH,"Muskingum County, OH",39532,37592,1940,7,52105,89
39121,OH,"Noble County, OH",4699,4377,322,6,50788,87
39123,OH,"Ottawa County, OH",21050,19862,1188,4,63352,108
39125,OH,"Paulding County, OH",8628,8297,331,5,58100,99
39127,OH,"Perry County, OH",15914,15087,827,4,51875,88
39129,OH,"Pickaway County, OH",26460,25404,1056,6,63931,109
39131,OH,"Pike County, OH",10824,10155,669,4,46255,79
39133,OH,"Portage County, OH",87309,83621,3688,4,57439,98
39135,OH,"Preble County, OH",21136,20342,794,3,62128,106
39137,OH,"Putnam County, OH",18817,18235,582,5,73454,125
39139,OH,"Richland County, OH",52246,49884,2362,4,51883,88
39141,OH,"Ross County, OH",35318,33829,1489,4,54728,93
39143,OH,"Sandusky County, OH",30506,29193,1313,6,58415,100
39145,OH,"Scioto County, OH",28862,27056,1806,4,45410,77
39147,OH,"Seneca County, OH",27313,26184,1129,4,55664,95
39149,OH,"Shelby County, OH",24178,23325,853,5,64304,110
39151,OH,"Stark County, OH",185736,177352,8384,4,55623,95
39153,OH,"Summit County, OH",272341,260690,11651,6,57753,98
39155,OH,"Trumbull County, OH",86758,81440,5318,4,47966,82
39157,OH,"Tuscarawas County, OH",44840,42908,1932,3,54150,92
39159,OH,"Union County, OH",28974,28041,933,3,91597,156
39161,OH,"Van Wert County, OH",15054,14563,491,6,55361,94
39163,OH,"Vinton County, OH",5560,5246,314,4,46301,79
39165,OH,"Warren County, OH",119179,115000,4179,5,91645,156
39167,OH,"Washington County, OH",27390,25918,1472,3,52565,90
39169,OH,"Wayne County, OH",62073,60061,2012,3,58747,100
39171,OH,"Williams County, OH",18992,18363,629,4,54239,92
39173,OH,"Wood County, OH",71161,68553,2608,3,64723,110
39175,OH,"Wyandot County, OH",12975,12569,406,3,61733,105
40001,OK,"Adair County, OK",8061,7726,335,2,39589,73
40003,OK,"Alfalfa County, OK",2819,2761,58,4,57497,106
40005,OK,"Atoka County, OK",4920,4706,214,2,41872,77
40007,OK,"Beaver County, OK",2876,2819,57,3,55397,102
40009,OK,"Beckham County, OK",10494,10162,332,2,50512,93
40011,OK,"Blaine County, OK",4750,4655,95,3,50574,93
40013,OK,"Bryan County, OK",21334,20684,650,4,44074,81
40015,OK,"Caddo County, OK",11768,11346,422,3,45755,84
40017,OK,"Canadian County, OK",74245,72123,2122,3,75111,138
40019,OK,"Carter County, OK",21512,20772,740,4,51895,95
40021,OK,"Cherokee County, OK",18737,17989,748,5,45544,84
40023,OK,"Choctaw County, OK",5428,5166,262,2,37131,68
40025,OK,"Cimarron County, OK",1324,1301,23,3,47602,87
40027,OK,"Cleveland County, OK",142822,138776,4046,4,64706,119
40029,OK,"Coal County, OK",2480,2383,97,4,41273,76
40031,OK,"Comanche County, OK",48157,46396,1761,3,51184,94
40033,OK,"Cotton County, OK",2718,2632,86,4,46450,85
40035,OK,"Craig County, OK",5926,5715,211,4,42978,79
40037,OK,"Creek County, OK",31636,30465,1171,3,54737,101
40039,OK,"Custer County, OK",15675,15279,396,4,51803,95
40041,OK,"Delaware County, OK",17990,17304,686,2,44602,82
40043,OK,"Dewey County, OK",2891,2829,62,3,56316,103
40045,OK,"Ellis County, OK",2156,2102,54,3,54013,99
40047,OK,"Garfield County, OK",27069,26255,814,3,58381,107
40049,OK,"Garvin County, OK",12576,12174,402,3,46786,86
40051,OK,"Grady County, OK",26474,25657,817,2,63647,117
40053,OK,"Grant County, OK",2650,2594,56,4,60303,111
40055,OK,"Greer County, OK",1836,1758,78,3,38641,71
40057,OK,"Harmon County, OK",1174,1140,34,3,37988,70
40059,OK,"Harper County, OK",1748,1697,51,5,40265,74
40061,OK,"Haskell County, OK",4217,3994,223,5,41643,77
40063,OK,"Hughes County, OK",5316,5057,259,3,37631,69
40065,OK,"Jackson County, OK",10650,10337,313,3,48430,89
40067,OK,"Jefferson County, OK",2506,2425,81,4,39785,73
40069,OK,"Johnston County, OK",3755,3593,162,4,41805,77
40071,OK,"Kay County, OK",18307,17526,781,2,48522,89
40073,OK,"Kingfisher County, OK",9142,8955,187,4,68839,126
40075,OK,"Kiowa County, OK",3453,3323,130,6,39788,73
40077,OK,"Latimer County, OK",3135,2937,198,5,42014,77
40079,OK,"Le Flore County, OK",19035,18141,894,4,42378,78
40081,OK,"Lincoln County, OK",15776,15219,557,3,51012,94
40083,OK,"Logan County, OK",22081,21445,636,2,66625,122
40085,OK,"Love County, OK",6170,6030,140,3,51481,95
40087,OK,"McClain County, OK",19628,19092,536,6,75009,138
40089,OK,"McCurtain County, OK",14383,13570,813,6,40803,75
40091,OK,"McIntosh County, OK",7067,6654,413,2,40614,75
40093,OK,"Major County, OK",3871,3788,83,4,59690,110
40095,OK,"Marshall County, OK",6880,6642,238,3,45005,83
40097,OK,"Mayes County, OK",19411,18802,609,3,49293,91
40099,OK,"Murray County, OK",6307,6117,190,4,50965,94
40101,OK,"Muskogee County, OK",29568,28418,1150,3,43392,80
40103,OK,"Noble County, OK",5669,5530,139,4,56307,103
40105,OK,"Nowata County, OK",4593,4434,159,5,47456,87
40107,OK,"Okfuskee County, OK",4614,4402,212,3,39265,72
40109,OK,"Oklahoma County, OK",384731,372632,12099,5,56272,103
40111,OK,"Okmulgee County, OK",15712,14943,769,4,41725,77
40113,OK,"Osage County, OK",20704,19921,783,3,50667,93
40115,OK,"Ottawa County, OK",14077,13599,478,4,41530,76
40117,OK,"Pawnee County, OK",7363,7074,289,3,47646,88
40119,OK,"Payne County, OK",37930,36836,1094,4,43025,79
40121,OK,"Pittsburg County, OK",17129,16406,723,3,47215,87
40123,OK,"Pontotoc County, OK",19044,18451,593,4,49510,91
40125,OK,"Pottawatomie County, OK",32342,31169,1173,5,52747,97
40127,OK,"Pushmataha County, OK",4278,4066,212,3,37718,69
40129,OK,"Roger Mills County, OK",1878,1822,56,3,59286,109
40131,OK,"Rogers County, OK",45151,43759,1392,5,67054,123
40133,OK,"Seminole County, OK",9434,8979,455,4,40725,75
40135,OK,"Sequoyah County, OK",16168,15502,666,4,43038,79
40137,OK,"Stephens County, OK",18536,17737,799,2,47826,88
40139,OK,"Texas County, OK",11189,10969,220,4,56014,103
40141,OK,"Tillman County, OK",2989,2879,110,3,41251,76
40143,OK,"Tulsa County, OK",323670,313397,10273,3,57668,106
40145,OK,"Wagoner County, OK",37999,36806,1193,3,65191,120
40147,OK,"Washington County, OK",22310,21547,763,3,62515,115
40149,OK,"Washita County, OK",5203,5028,175,2,50823,93
40151,OK,"Woods County, OK",4601,4505,96,3,40684,75
40153,OK,"Woodward County, OK",8988,8727,261,4,73253,135
41001,OR,"Baker County, OR",7120,6789,331,3,48530,73
41003,OR,"Benton County, OR",48151,46736,1415,3,69148,103
41005,OR,"Clackamas County, OR",219468,212043,7425,4,80539,120
41007,OR,"Clatsop County, OR",19385,18659,726,5,59339,89
41009,OR,"Columbia County, OR",24437,23340,1097,5,72285,108
41011,OR,"Coos County, OR",26147,24874,1273,5,49504,74
41013,OR,"Crook County, OR",9593,9083,510,5,58739,88
41015,OR,"Curry County, OR",8895,8432,463,4,51267,77
41017,OR,"Deschutes County, OR",96093,92361,3732,5,71880,107
41019,OR,"Douglas County, OR",46339,44063,2276,4,48940,73
41021,OR,"Gilliam County, OR",947,912,35,7,61205,91
41023,OR,"Grant County, OR",3185,2964,221,5,49792,74
41025,OR,"Harney County, OR",3577,3387,190,3,39874,60
41027,OR,"Hood River County, OR",14470,14012,458,4,68835,103
41029,OR,"Jackson County, OR",103451,98950,4501,5,56367,84
41031,OR,"Jefferson County, OR",10125,9613,512,5,52543,79
41033,OR,"Josephine County, OR",35786,34004,1782,6,47533,71
41035,OR,"Klamath County, OR",29291,27485,1806,5,53030,79
41037,OR,"Lake County, OR",3628,3433,195,4,47867,72
41039,OR,"Lane County, OR",180588,173271,7317,4,57212,85
41041,OR,"Lincoln County, OR",20848,19947,901,4,52276,78
41043,OR,"Linn County, OR",58720,56191,2529,4,61084,91
41045,OR,"Malheur County, OR",12314,11804,510,4,42019,63
41047,OR,"Marion County, OR",161879,155513,6366,4,64058,96
41049,OR,"Morrow County, OR",5712,5477,235,3,59781,89
41051,OR,"Multnomah County, OR",455189,440311,14878,4,72469,108
41053,OR,"Polk County, OR",39860,38240,1620,3,69757,104
41055,OR,"Sherman County, OR",932,900,32,4,60035,90
41057,OR,"Tillamook County, OR",11879,11421,458,5,52298,78
41059,OR,"Umatilla County, OR",36779,35014,1765,5,58286,87
41061,OR,"Union County, OR",11938,11362,576,6,54264,81
41063,OR,"Wallowa County, OR",3420,3221,199,4,52106,78
41065,OR,"Wasco County, OR",13360,12809,551,3,56993,85
41067,OR,"Washington County, OR",325006,315008,9998,4,85665,128
41069,OR,"Wheeler County, OR",722,691,31,3,42747,64
41071,OR,"Yamhill County, OR",54839,52981,1858,4,71815,107
42001,PA,"Adams County, PA",55350,53531,1819,4,67706,107
42003,PA,"Allegheny County, PA",649873,623045,26828,5,64799,102
42005,PA,"Armstrong County, PA",32307,30671,1636,5,56259,89
42007,PA,"Beaver County, PA",84172,80367,3805,5,60323,95
42009,PA,"Bedford County, PA",23622,22510,1112,4,54251,86
42011,PA,"Berks County, PA",216147,206763,9384,5,67418,106
42013,PA,"Blair County, PA",59551,56860,2691,4,51004,80
42015,PA,"Bradford County, PA",28959,27697,1262,4,51356,81
42017,PA,"Bucks County, PA",345279,332053,13226,4,93587,148
42019,PA,"Butler County, PA",99994,96090,3904,5,72576,114
42021,PA,"Cambria County, PA",58064,54963,3101,6,48798,77
42023,PA,"Cameron County, PA",2088,1963,125,5,43704,69
42025,PA,"Carbon County, PA",32252,30516,1736,3,59985,95
42027,PA,"Centre County, PA",80144,77464,2680,3,61036,96
42029,PA,"Chester County, PA",286480,277341,9139,5,102233,161
42031,PA,"Clarion County, PA",17131,16289,842,5,49173,78
42033,PA,"Clearfield County, PA",35987,34114,1873,5,46967,74
42035,PA,"Clinton County, PA",18338,17347,991,5,50777,80
42037,PA,"Columbia County, PA",33552,31955,1597,5,54377,86
42039,PA,"Crawford County, PA",38685,36853,1832,3,49741,78
42041,PA,"Cumberland County, PA",132626,128165,4461,4,75269,119
42043,PA,"Dauphin County, PA",144836,139003,5833,4,60763,96
42045,PA,"Delaware County, PA",299802,287670,12132,5,76783,121
42047,PA,"Elk County, PA",15677,14911,766,5,55462,87
42049,PA,"Erie County, PA",128841,122943,5898,6,51923,82
42051,PA,"Fayette County, PA",57273,53868,3405,7,48055,76
42053,PA,"Forest County, PA",1818,1694,124,4,41267,65
42055,PA,"Franklin County, PA",77887,74904,2983,4,62699,99
42057,PA,"Fulton County, PA",7907,7560,347,5,56357,89
42059,PA,"Greene County, PA",16626,15771,855,6,56599,89
42061,PA,"Huntingdon County, PA",20012,18833,1179,5,54323,86
42063,PA,"Indiana County, PA",39155,37186,1969,5,51299,81
42065,PA,"Jefferson County, PA",20587,19612,975,4,50789,80
42067,PA,"Juniata County, PA",12616,12061,555,5,57837,91
42069,PA,"Lackawanna County, PA",105216,100057,5159,3,53655,85
42071,PA,"Lancaster County, PA",285253,275432,9821,5,67515,106
42073,PA,"Lawrence County, PA",40775,38687,2088,4,50979,80
42075,PA,"Lebanon County, PA",72617,69798,2819,5,61560,97
42077,PA,"Lehigh County, PA",193388,184665,8723,6,65436,103
42079,PA,"Luzerne County, PA",157695,148722,8973,5,53439,84
42081,PA,"Lycoming County, PA",56919,54169,2750,5,53762,85
42083,PA,"McKean County, PA",17355,16435,920,5,53266,84
42085,PA,"Mercer County, PA",49321,46909,2412,5,54099,85
42087,PA,"Mifflin County, PA",21076,20093,983,5,50571,80
42089,PA,"Monroe County, PA",83291,78812,4479,4,63012,99
42091,PA,"Montgomery County, PA",456383,440364,16019,4,92340,146
42093,PA,"Montour County, PA",9122,8795,327,5,65534,103
42095,PA,"Northampton County, PA",161856,154642,7214,6,73780,116
42097,PA,"Northumberland County, PA",43184,40765,2419,4,47967,76
42099,PA,"Perry County, PA",24583,23673,910,6,65401,103
42101,PA,"Philadelphia County/city, PA",722078,682012,40066,6,47598,75
42103,PA,"Pike County, PA",25321,23909,1412,6,66595,105
42105,PA,"Potter County, PA",7209,6784,425,5,49054,77
42107,PA,"Schuylkill County, PA",66554,62948,3606,5,55951,88
42109,PA,"Snyder County, PA",20172,19079,1093,5,56873,90
42111,PA,"Somerset County, PA",33659,31869,1790,5,49082,77
42113,PA,"Sullivan County, PA",2671,2531,140,4,51718,82
42115,PA,"Susquehanna County, PA",20606,19717,889,5,60235,95
42117,PA,"Tioga County, PA",19148,18139,1009,4,51324,81
42119,PA,"Union County, PA",19912,19114,798,5,61306,97
42121,PA,"Venango County, PA",22444,21354,1090,5,53619,85
42123,PA,"Warren County, PA",18977,18116,861,5,52592,83
42125,PA,"Washington County, PA",107299,102475,4824,5,65558,103
42127,PA,"Wayne County, PA",22486,21427,1059,5,56265,89
42129,PA,"Westmoreland County, PA",181453,173320,8133,5,59407,94
42131,PA,"Wyoming County, PA",13610,12948,662,4,60419,95
42133,PA,"York County, PA",236377,227297,9080,4,69101,109
44001,RI,"Bristol County, RI",26005,25226,779,3,87926,125
44003,RI,"Kent County, RI",90729,87815,2914,3,74230,106
44005,RI,"Newport County, RI",44280,42905,1375,4,80862,115
44007,RI,"Providence County, RI",325490,312930,12560,3,62165,88
44009,RI,"Washington County, RI",69050,66892,2158,3,86450,123
45001,SC,"Abbeville County, SC",10050,9711,339,3,46499,83
45003,SC,"Aiken County, SC",75105,72929,2176,5,56824,101
45005,SC,"Allendale County, SC",2692,2549,143,3,32147,57
45007,SC,"Anderson County, SC",91576,89109,2467,6,54496,97
45009,SC,"Bamberg County, SC",4981,4704,277,4,35364,63
45011,SC,"Barnwell County, SC",8268,7916,352,3,36675,65
45013,SC,"Beaufort County, SC",77858,75797,2061,3,73890,131
45015,SC,"Berkeley County, SC",104452,101801,2651,4,68690,122
45017,SC,"Calhoun County, SC",6604,6367,237,2,47090,84
45019,SC,"Charleston County, SC",212354,207473,4881,3,70980,126
45021,SC,"Cherokee County, SC",25196,24422,774,4,46905,83
45023,SC,"Chester County, SC",13445,12890,555,3,45400,81
45025,SC,"Chesterfield County, SC",22128,21484,644,4,42441,75
45027,SC,"Clarendon County, SC",12731,12238,493,3,39900,71
45029,SC,"Colleton County, SC",16821,16283,538,3,40808,72
45031,SC,"Darlington County, SC",30561,29518,1043,4,44007,78
45033,SC,"Dillon County, SC",13029,12496,533,3,35483,63
45035,SC,"Dorchester County, SC",78453,76502,1951,3,68051,121
45037,SC,"Edgefield County, SC",10753,10452,301,4,52591,93
45039,SC,"Fairfield County, SC",9619,9192,427,3,42496,75
45041,SC,"Florence County, SC",67211,65235,1976,4,49770,88
45043,SC,"Georgetown County, SC",25790,24820,970,2,53747,95
45045,SC,"Greenville County, SC",255903,249678,6225,3,64399,114
45047,SC,"Greenwood County, SC",31377,30397,980,3,43958,78
45049,SC,"Hampton County, SC",8416,8187,229,4,37560,67
45051,SC,"Horry County, SC",148573,143234,5339,3,53648,95
45053,SC,"Jasper County, SC",12685,12363,322,3,50790,90
45055,SC,"Kershaw County, SC",29291,28425,866,3,56318,100
45057,SC,"Lancaster County, SC",41340,39956,1384,3,63842,113
45059,SC,"Laurens County, SC",30313,29410,903,4,47038,84
45061,SC,"Lee County, SC",6618,6352,266,2,37710,67
45063,SC,"Lexington County, SC",150160,146650,3510,3,62059,110
45065,SC,"McCormick County, SC",3389,3285,104,4,48645,86
45067,SC,"Marion County, SC",13045,12481,564,5,35138,62
45069,SC,"Marlboro County, SC",9183,8739,444,3,34532,61
45071,SC,"Newberry County, SC",19223,18709,514,3,50773,90
45073,SC,"Oconee County, SC",35039,34068,971,5,52240,93
45075,SC,"Orangeburg County, SC",34842,33187,1655,3,38736,69
45077,SC,"Pickens County, SC",57667,56063,1604,3,52949,94
45079,SC,"Richland County, SC",198948,193369,5579,3,52905,94
45081,SC,"Saluda County, SC",8928,8690,238,3,49493,88
45083,SC,"Spartanburg County, SC",153496,149576,3920,3,55588,99
45085,SC,"Sumter County, SC",43727,42254,1473,4,49611,88
45087,SC,"Union County, SC",11681,11275,406,5,42851,76
45089,SC,"Williamsburg County, SC",12093,11542,551,3,34409,61
45091,SC,"York County, SC",140458,136587,3871,3,68468,122
46003,SD,"Aurora County, SD",1527,1485,42,3,56360,93
46005,SD,"Beadle County, SD",9618,9315,303,5,51844,86
46007,SD,"Bennett County, SD",1091,1032,59,3,36345,60
46009,SD,"Bon Homme County, SD",2870,2779,91,3,52660,87
46011,SD,"Brookings County, SD",19138,18511,627,3,59036,98
46013,SD,"Brown County, SD",20795,20152,643,3,61447,102
46015,SD,"Brule County, SD",2451,2375,76,7,65008,108
46017,SD,"Buffalo County, SD",683,638,45,3,26671,44
46019,SD,"Butte County, SD",5044,4873,171,4,50105,83
46021,SD,"Campbell County, SD",772,744,28,4,56043,93
46023,SD,"Charles Mix County, SD",3763,3622,141,4,51340,85
46025,SD,"Clark County, SD",1913,1836,77,3,54158,90
46027,SD,"Clay County, SD",7432,7184,248,3,51039,85
46029,SD,"Codington County, SD",15518,15028,490,6,63442,105
46031,SD,"Corson County, SD",1368,1289,79,4,32848,54
46033,SD,"Custer County, SD",4009,3831,178,3,63665,105
46035,SD,"Davison County, SD",11103,10778,325,5,57367,95
46037,SD,"Day County, SD",2763,2637,126,5,51516,85
46039,SD,"Deuel County, SD",2172,2067,105,8,65217,108
46041,SD,"Dewey County, SD",2228,2044,184,3,47640,79
46043,SD,"Douglas County, SD",1584,1539,45,3,56030,93
46045,SD,"Edmunds County, SD",2041,1980,61,4,59905,99
46047,SD,"Fall River County, SD",2992,2864,128,3,49965,83
46049,SD,"Faulk County, SD",1058,1023,35,3,49198,81
46051,SD,"Grant County, SD",4443,4293,150,4,60057,99
46053,SD,"Gregory County, SD",2048,1977,71,3,42868,71
46055,SD,"Haakon County, SD",1051,1020,31,3,50747,84
46057,SD,"Hamlin County, SD",3319,3210,109,3,60864,101
46059,SD,"Hand County, SD",1783,1733,50,5,56239,93
46061,SD,"Hanson County, SD",1745,1663,82,3,78478,130
46063,SD,"Harding County, SD",725,705,20,3,55482,92
46065,SD,"Hughes County, SD",10039,9771,268,3,66952,111
46067,SD,"Hutchinson County, SD",3598,3486,112,4,59336,98
46069,SD,"Hyde County, SD",682,658,24,6,63454,105
46071,SD,"Jackson County, SD",1272,1199,73,3,37879,63
46073,SD,"Jerauld County, SD",1117,1086,31,3,52162,86
46075,SD,"Jones County, SD",544,527,17,3,52650,87
46077,SD,"Kingsbury County, SD",2671,2590,81,4,61992,103
46079,SD,"Lake County, SD",6684,6443,241,3,63946,106
46081,SD,"Lawrence County, SD",13343,12915,428,3,53902,89
46083,SD,"Lincoln County, SD",34595,33709,886,5,86235,143
46085,SD,"Lyman County, SD",1690,1609,81,3,47813,79
46087,SD,"McCook County, SD",3078,2990,88,4,62535,104
46089,SD,"McPherson County, SD",1006,963,43,4,43243,72
46091,SD,"Marshall County, SD",2383,2292,91,4,59103,98
46093,SD,"Meade County, SD",14138,13632,506,6,59981,99
46095,SD,"Mellette County, SD",741,699,42,3,36489,60
46097,SD,"Miner County, SD",1177,1140,37,3,52230,87
46099,SD,"Minnehaha County, SD",113094,109853,3241,4,63162,105
46101,SD,"Moody County, SD",4041,3895,146,10,61029,101
46102,SD,"Oglala Lakota County, SD",3570,3222,348,3,34078,56
46103,SD,"Pennington County, SD",56757,54827,1930,3,58919,98
46105,SD,"Perkins County, SD",1425,1381,44,3,49999,83
46107,SD,"Potter County, SD",1045,1012,33,4,58012,96
46109,SD,"Roberts County, SD",4839,4630,209,3,49088,81
46111,SD,"Sanborn County, SD",1153,1117,36,3,56507,94
46115,SD,"Spink County, SD",3189,3080,109,3,54666,91
46117,SD,"Stanley County, SD",1850,1795,55,3,70472,117
46119,SD,"Sully County, SD",800,777,23,7,61791,102
46121,SD,"Todd County, SD",3166,2961,205,3,34015,56
46123,SD,"Tripp County, SD",3070,2981,89,3,50503,84
46125,SD,"Turner County, SD",4702,4559,143,3,63852,106
46127,SD,"Union County, SD",8484,8192,292,6,83910,139
46129,SD,"Walworth County, SD",2125,2008,117,3,51472,85
46135,SD,"Yankton County, SD",11958,11615,343,6,60868,101
46137,SD,"Ziebach County, SD",930,878,52,3,33508,56
47001,TN,"Anderson County, TN",34949,33708,1241,4,50973,91
47003,TN,"Bedford County, TN",21223,20437,786,5,50539,90
47005,TN,"Benton County, TN",6964,6653,311,5,42322,76
47007,TN,"Bledsoe County, TN",4346,4111,235,3,42730,76
47009,TN,"Blount County, TN",64115,62072,2043,4,59368,106
47011,TN,"Bradley County, TN",52465,50654,1811,5,52534,94
47013,TN,"Campbell County, TN",14978,14291,687,3,42500,76
47015,TN,"Cannon County, TN",6686,6481,205,5,52960,95
47017,TN,"Carroll County, TN",12172,11582,590,4,43258,77
47019,TN,"Carter County, TN",24218,23235,983,3,39964,71
47021,TN,"Cheatham County, TN",22186,21606,580,3,62786,112
47023,TN,"Chester County, TN",8640,8343,297,4,50769,91
47025,TN,"Claiborne County, TN",13178,12624,554,6,40116,72
47027,TN,"Clay County, TN",2808,2640,168,5,36694,66
47029,TN,"Cocke County, TN",15164,14477,687,3,40528,72
47031,TN,"Coffee County, TN",25749,24891,858,4,54931,98
47033,TN,"Crockett County, TN",7069,6823,246,5,45642,81
47035,TN,"Cumberland County, TN",23685,22624,1061,3,49142,88
47037,TN,"Davidson County, TN",409810,399502,10308,5,63846,114
47039,TN,"Decatur County, TN",4611,4366,245,4,45215,81
47041,TN,"DeKalb County, TN",7855,7516,339,3,46407,83
47043,TN,"Dickson County, TN",27409,26593,816,5,59126,106
47045,TN,"Dyer County, TN",16597,15792,805,4,48770,87
47047,TN,"Fayette County, TN",19370,18663,707,4,67345,120
47049,TN,"Fentress County, TN",7555,7240,315,3,38608,69
47051,TN,"Franklin County, TN",20343,19663,680,4,54319,97
47053,TN,"Gibson County, TN",22262,21320,942,4,46384,83
47055,TN,"Giles County, TN",15126,14543,583,4,50847,91
47057,TN,"Grainger County, TN",9608,9221,387,5,44929,80
47059,TN,"Greene County, TN",29995,28599,1396,4,44975,80
47061,TN,"Grundy County, TN",5017,4809,208,4,38447,69
47063,TN,"Hamblen County, TN",28385,27292,1093,3,46842,84
47065,TN,"Hamilton County, TN",185402,179393,6009,6,57802,103
47067,TN,"Hancock County, TN",2130,2005,125,5,31938,57
47069,TN,"Hardeman County, TN",9576,9099,477,4,40989,73
47071,TN,"Hardin County, TN",10486,10038,448,4,44510,79
47073,TN,"Hawkins County, TN",23986,22998,988,5,46602,83
47075,TN,"Haywood County, TN",7749,7373,376,4,38950,70
47077,TN,"Henderson County, TN",12369,11832,537,4,46826,84
47079,TN,"Henry County, TN",14321,13727,594,3,43159,77
47081,TN,"Hickman County, TN",11599,11243,356,5,46176,82
47083,TN,"Houston County, TN",3297,3146,151,4,40915,73
47085,TN,"Humphreys County, TN",9025,8678,347,5,52121,93
47087,TN,"Jackson County, TN",4702,4486,216,4,41749,75
47089,TN,"Jefferson County, TN",24800,23882,918,4,50332,90
47091,TN,"Johnson County, TN",7730,7462,268,3,40219,72
47093,TN,"Knox County, TN",246227,239090,7137,6,60316,108
47095,TN,"Lake County, TN",1779,1678,101,5,34059,61
47097,TN,"Lauderdale County, TN",9794,9262,532,4,43545,78
47099,TN,"Lawrence County, TN",19432,18640,792,4,43448,78
47101,TN,"Lewis County, TN",5221,5010,211,4,45874,82
47103,TN,"Lincoln County, TN",16900,16295,605,3,54558,97
47105,TN,"Loudon County, TN",23696,22895,801,4,65226,116
47107,TN,"McMinn County, TN",23880,22978,902,5,49836,89
47109,TN,"McNairy County, TN",8580,8130,450,3,45469,81
47111,TN,"Macon County, TN",11435,11079,356,4,44334,79
47113,TN,"Madison County, TN",49493,47727,1766,4,50401,90
47115,TN,"Marion County, TN",12598,12057,541,4,47675,85
47117,TN,"Marshall County, TN",15860,15305,555,3,58151,104
47119,TN,"Maury County, TN",50157,48575,1582,5,66434,119
47121,TN,"Meigs County, TN",5230,4992,238,4,48334,86
47123,TN,"Monroe County, TN",20356,19613,743,4,50506,90
47125,TN,"Montgomery County, TN",86220,82946,3274,3,57606,103
47127,TN,"Moore County, TN",3635,3529,106,4,61804,110
47129,TN,"Morgan County, TN",7956,7632,324,5,43952,78
47131,TN,"Obion County, TN",12615,11999,616,4,44061,79
47133,TN,"Overton County, TN",10026,9647,379,5,43636,78
47135,TN,"Perry County, TN",3146,2988,158,5,42939,77
47137,TN,"Pickett County, TN",2385,2274,111,4,41860,75
47139,TN,"Polk County, TN",7576,7274,302,4,45922,82
47141,TN,"Putnam County, TN",35355,34124,1231,6,49083,88
47143,TN,"Rhea County, TN",13401,12636,765,4,47599,85
47145,TN,"Roane County, TN",23617,22662,955,3,50561,90
47147,TN,"Robertson County, TN",38549,37440,1109,3,65790,117
47149,TN,"Rutherford County, TN",186696,181904,4792,4,69614,124
47151,TN,"Scott County, TN",8427,8059,368,4,38750,69
47153,TN,"Sequatchie County, TN",6250,5987,263,3,46876,84
47155,TN,"Sevier County, TN",55225,53420,1805,4,54476,97
47157,TN,"Shelby County, TN",449965,431885,18080,3,52659,94
47159,TN,"Smith County, TN",9589,9301,288,5,54570,97
47161,TN,"Stewart County, TN",5540,5292,248,4,52177,93
47163,TN,"Sullivan County, TN",70979,68347,2632,3,51303,92
47165,TN,"Sumner County, TN",103810,101033,2777,4,69391,124
47167,TN,"Tipton County, TN",28461,27356,1105,3,61436,110
47169,TN,"Trousdale County, TN",5503,5335,168,5,51982,93
47171,TN,"Unicoi County, TN",7167,6809,358,4,44548,80
47173,TN,"Union County, TN",7698,7387,311,5,48106,86
47175,TN,"Van Buren County, TN",2072,1979,93,4,44451,79
47177,TN,"Warren County, TN",16869,16178,691,4,46144,82
47179,TN,"Washington County, TN",60904,58800,2104,5,51879,93
47181,TN,"Wayne County, TN",6301,6007,294,4,45091,81
47183,TN,"Weakley County, TN",16267,15610,657,4,42506,76
47185,TN,"White County, TN",12363,11908,455,2,43583,78
47187,TN,"Williamson County, TN",130215,127057,3158,3,119637,214
47189,TN,"Wilson County, TN",77728,75639,2089,4,80080,143
48001,TX,"Anderson County, TX",23913,23220,693,2,48461,76
48003,TX,"Andrews County, TX",9906,9685,221,4,74918,117
48005,TX,"Angelina County, TX",35893,34453,1440,4,51750,81
48007,TX,"Aransas County, TX",9425,9022,403,3,53085,83
48009,TX,"Archer County, TX",4145,4027,118,3,63731,100
48011,TX,"Armstrong County, TX",929,904,25,4,64424,101
48013,TX,"Atascosa County, TX",21707,20928,779,3,57309,90
48015,TX,"Austin County, TX",14096,13613,483,4,68311,107
48017,TX,"Bailey County, TX",2508,2415,93,3,46174,72
48019,TX,"Bandera County, TX",10071,9742,329,3,59604,93
48021,TX,"Bastrop County, TX",42900,41609,1291,2,62627,98
48023,TX,"Baylor County, TX",1765,1725,40,4,41539,65
48025,TX,"Bee County, TX",9853,9419,434,4,44171,69
48027,TX,"Bell County, TX",143858,138392,5466,3,54831,86
48029,TX,"Bexar County, TX",949380,919763,29617,2,58956,92
48031,TX,"Blanco County, TX",6469,6311,158,3,68404,107
48033,TX,"Borden County, TX",404,394,10,3,71926,112
48035,TX,"Bosque County, TX",8343,8058,285,4,55179,86
48037,TX,"Bowie County, TX",39899,38130,1769,4,51207,80
48039,TX,"Brazoria County, TX",179539,172008,7531,3,83704,131
48041,TX,"Brazos County, TX",119010,115819,3191,3,54471,85
48043,TX,"Brewster County, TX",4207,4084,123,4,48581,76
48045,TX,"Briscoe County, TX",578,558,20,5,44259,69
48047,TX,"Brooks County, TX",2602,2468,134,4,31410,49
48049,TX,"Brown County, TX",15701,15117,584,3,56040,88
48051,TX,"Burleson County, TX",8362,8103,259,3,61745,96
48053,TX,"Burnet County, TX",23570,22930,640,3,62827,98
48055,TX,"Caldwell County, TX",19669,19011,658,3,55301,86
48057,TX,"Calhoun County, TX",12168,11776,392,3,55909,87
48059,TX,"Callahan County, TX",6113,5925,188,6,50812,79
48061,TX,"Cameron County, TX",166861,157675,9186,4,40893,64
48063,TX,"Camp County, TX",4975,4766,209,3,47091,74
48065,TX,"Carson County, TX",3011,2933,78,4,69760,109
48067,TX,"Cass County, TX",12430,11895,535,3,44529,70
48069,TX,"Castro County, TX",3433,3337,96,5,51736,81
48071,TX,"Chambers County, TX",19489,18604,885,4,93351,146
48073,TX,"Cherokee County, TX",20936,20143,793,3,46576,73
48075,TX,"Childress County, TX",2952,2872,80,3,44095,69
48077,TX,"Clay County, TX",4936,4785,151,3,59983,94
48079,TX,"Cochran County, TX",1123,1085,38,3,43742,68
48081,TX,"Coke County, TX",1456,1409,47,4,48435,76
48083,TX,"Coleman County, TX",2888,2770,118,3,44834,70
48085,TX,"Collin County, TX",563678,546320,17358,3,96847,151
48087,TX,"Collingsworth County, TX",1157,1120,37,3,40314,63
48089,TX,"Colorado County, TX",9860,9557,303,3,55607,87
48091,TX,"Comal County, TX",73333,71149,2184,3,87976,137
48093,TX,"Comanche County, TX",5591,5410,181,3,54122,85
48095,TX,"Concho County, TX",1238,1198,40,3,43321,68
48097,TX,"Cooke County, TX",19820,19268,552,4,61186,96
48099,TX,"Coryell County, TX",24123,23177,946,4,53083,83
48101,TX,"Cottle County, TX",551,528,23,4,40449,63
48103,TX,"Crane County, TX",1569,1506,63,3,68626,107
48105,TX,"Crockett County, TX",1637,1589,48,4,54165,85
48107,TX,"Crosby County, TX",2499,2402,97,4,38871,61
48109,TX,"Culberson County, TX",1044,1002,42,2,44462,69
48111,TX,"Dallam County, TX",3918,3842,76,4,55793,87
48113,TX,"Dallas County, TX",1364652,1317507,47145,4,61807,97
48115,TX,"Dawson County, TX",4642,4462,180,3,48165,75
48117,TX,"Deaf Smith County, TX",8470,8237,233,3,46178,72
48119,TX,"Delta County, TX",2443,2360,83,3,51348,80
48121,TX,"Denton County, TX",494624,480005,14619,3,90910,142
48123,TX,"DeWitt County, TX",9798,9540,258,4,52544,82
48125,TX,"Dickens County, TX",682,652,30,3,41973,66
48127,TX,"Dimmit County, TX",7487,7298,189,4,40315,63
48129,TX,"Donley County, TX",1439,1389,50,5,41093,64
48131,TX,"Duval County, TX",4966,4744,222,3,37100,58
48133,TX,"Eastland County, TX",8354,8079,275,3,46991,73
48135,TX,"Ector County, TX",88186,85859,2327,2,65564,102
48137,TX,"Edwards County, TX",1054,1030,24,3,40424,63
48139,TX,"Ellis County, TX",92694,89823,2871,4,78341,122
48141,TX,"El Paso County, TX",362582,348712,13870,3,48629,76
48143,TX,"Erath County, TX",20850,20188,662,3,53044,83
48145,TX,"Falls County, TX",6570,6356,214,3,41484,65
48147,TX,"Fannin County, TX",17329,16854,475,3,56123,88
48149,TX,"Fayette County, TX",12313,11987,326,3,62195,97
48151,TX,"Fisher County, TX",1634,1586,48,4,51053,80
48153,TX,"Floyd County, TX",2580,2468,112,3,45022,70
48155,TX,"Foard County, TX",585,567,18,4,38615,60
48157,TX,"Fort Bend County, TX",392275,378653,13622,4,101361,158
48159,TX,"Franklin County, TX",4654,4485,169,5,50630,79
48161,TX,"Freestone County, TX",6400,6093,307,3,52511,82
48163,TX,"Frio County, TX",10463,10192,271,2,40360,63
48165,TX,"Gaines County, TX",9812,9577,235,4,67171,105
48167,TX,"Galveston County, TX",165479,158807,6672,3,73214,114
48169,TX,"Garza County, TX",2176,2117,59,2,48975,77
48171,TX,"Gillespie County, TX",13542,13213,329,2,62143,97
48173,TX,"Glasscock County, TX",795,778,17,3,93759,146
48175,TX,"Goliad County, TX",3272,3162,110,3,56758,89
48177,TX,"Gonzales County, TX",9578,9320,258,4,48425,76
48179,TX,"Gray County, TX",8080,7791,289,3,52543,82
48181,TX,"Grayson County, TX",64106,62148,1958,4,57439,90
48183,TX,"Gregg County, TX",58349,56176,2173,4,53137,83
48185,TX,"Grimes County, TX",11264,10822,442,3,51651,81
48187,TX,"Guadalupe County, TX",81486,79087,2399,5,78801,123
48189,TX,"Hale County, TX",12210,11663,547,4,49187,77
48191,TX,"Hall County, TX",1073,1029,44,3,35940,56
48193,TX,"Hamilton County, TX",3672,3561,111,2,52505,82
48195,TX,"Hansford County, TX",2779,2714,65,3,58703,92
48197,TX,"Hardeman County, TX",1722,1670,52,5,40057,63
48199,TX,"Hardin County, TX",25321,24158,1163,4,62616,98
48201,TX,"Harris County, TX",2317346,2228703,88643,4,61638,96
48203,TX,"Harrison County, TX",29485,28306,1179,2,55171,86
48205,TX,"Hartley County, TX",2802,2756,46,3,72796,114
48207,TX,"Haskell County, TX",2285,2210,75,3,38613,60
48209,TX,"Hays County, TX",119874,116574,3300,3,72890,114
48211,TX,"Hemphill County, TX",1937,1884,53,4,71299,111
48213,TX,"Henderson County, TX",36518,35239,1279,6,49896,78
48215,TX,"Hidalgo County, TX",352815,330817,21998,3,41656,65
48217,TX,"Hill County, TX",16409,15867,542,3,53210,83
48219,TX,"Hockley County, TX",11290,10956,334,3,51149,80
48221,TX,"Hood County, TX",27560,26625,935,3,74534,116
48223,TX,"Hopkins County, TX",17544,17008,536,3,50332,79
48225,TX,"Houston County, TX",10364,10039,325,3,43601,68
48227,TX,"Howard County, TX",14040,13604,436,4,61112,95
48229,TX,"Hudspeth County, TX",1827,1747,80,4,39309,61
48231,TX,"Hunt County, TX",43412,41871,1541,4,57513,90
48233,TX,"Hutchinson County, TX",8701,8315,386,2,57936,91
48235,TX,"Irion County, TX",761,743,18,3,68630,107
48237,TX,"Jack County, TX",3471,3362,109,3,55358,86
48239,TX,"Jackson County, TX",7588,7360,228,6,55800,87
48241,TX,"Jasper County, TX",12869,12083,786,3,47252,74
48243,TX,"Jeff Davis County, TX",1040,1010,30,6,53362,83
48245,TX,"Jefferson County, TX",106962,100737,6225,5,55173,86
48247,TX,"Jim Hogg County, TX",1884,1794,90,5,38788,61
48249,TX,"Jim Wells County, TX",16852,16054,798,3,44444,69
48251,TX,"Johnson County, TX",82176,79532,2644,4,66538,104
48253,TX,"Jones County, TX",5738,5494,244,3,51094,80
48255,TX,"Karnes County, TX",7187,7008,179,3,54843,86
48257,TX,"Kaufman County, TX",64597,62485,2112,3,75009,117
48259,TX,"Kendall County, TX",22132,21533,599,4,94899,148
48261,TX,"Kenedy County, TX",223,215,8,2,46132,72
48263,TX,"Kent County, TX",478,467,11,3,52591,82
48265,TX,"Kerr County, TX",22251,21593,658,3,57789,90
48267,TX,"Kimble County, TX",1862,1805,57,2,44757,70
48269,TX,"King County, TX",233,228,5,4,71256,111
48271,TX,"Kinney County, TX",1377,1327,50,4,47076,74
48273,TX,"Kleberg County, TX",13496,12908,588,3,47169,74
48275,TX,"Knox County, TX",1444,1397,47,3,40808,64
48277,TX,"Lamar County, TX",24052,23241,811,4,47061,74
48279,TX,"Lamb County, TX",5311,5108,203,3,42719,67
48281,TX,"Lampasas County, TX",9212,8910,302,2,58817,92
48283,TX,"La Salle County, TX",4401,4295,106,3,41683,65
48285,TX,"Lavaca County, TX",8590,8333,257,3,52632,82
48287,TX,"Lee County, TX",10120,9852,268,4,59250,93
48289,TX,"Leon County, TX",6325,6049,276,5,50522,79
48291,TX,"Liberty County, TX",33101,31432,1669,4,53274,83
48293,TX,"Limestone County, TX",8593,8260,333,3,43644,68
48295,TX,"Lipscomb County, TX",1650,1607,43,3,65388,102
48297,TX,"Live Oak County, TX",5564,5392,172,3,54163,85
48299,TX,"Llano County, TX",8679,8380,299,1,55617,87
48301,TX,"Loving County, TX",542,538,4,3,88487,138
48303,TX,"Lubbock County, TX",158134,153680,4454,3,54733,86
48305,TX,"Lynn County, TX",2775,2693,82,5,45737,71
48307,TX,"McCulloch County, TX",3488,3307,181,3,43262,68
48309,TX,"McLennan County, TX",119629,115668,3961,2,51078,80
48311,TX,"McMullen County, TX",821,808,13,4,68349,107
48313,TX,"Madison County, TX",4555,4361,194,4,46274,72
48315,TX,"Marion County, TX",4239,4058,181,3,37876,59
48317,TX,"Martin County, TX",2889,2814,75,3,68745,107
48319,TX,"Mason County, TX",1772,1715,57,6,54914,86
48321,TX,"Matagorda County, TX",16712,15766,946,8,49276,77
48323,TX,"Maverick County, TX",23803,22013,1790,3,40017,63
48325,TX,"Medina County, TX",21828,21142,686,4,60695,95
48327,TX,"Menard County, TX",862,832,30,2,38425,60
48329,TX,"Midland County, TX",107495,105290,2205,5,85811,134
48331,TX,"Milam County, TX",9788,9301,487,3,48989,77
48333,TX,"Mills County, TX",1904,1842,62,4,46876,73
48335,TX,"Mitchell County, TX",2325,2243,82,3,44457,69
48337,TX,"Montague County, TX",9323,9058,265,3,53649,84
48339,TX,"Montgomery County, TX",284078,274419,9659,2,88833,139
48341,TX,"Moore County, TX",10915,10660,255,5,55099,86
48343,TX,"Morris County, TX",4808,4552,256,4,43304,68
48345,TX,"Motley County, TX",483,466,17,4,40217,63
48347,TX,"Nacogdoches County, TX",28210,27153,1057,3,46207,72
48349,TX,"Navarro County, TX",24061,23283,778,6,48649,76
48351,TX,"Newton County, TX",5182,4858,324,3,45890,72
48353,TX,"Nolan County, TX",7066,6860,206,4,46389,72
48355,TX,"Nueces County, TX",167411,160536,6875,3,56079,88
48357,TX,"Ochiltree County, TX",4330,4213,117,3,62567,98
48359,TX,"Oldham County, TX",916,890,26,5,59404,93
48361,TX,"Orange County, TX",36395,34518,1877,3,62976,98
48363,TX,"Palo Pinto County, TX",13602,13175,427,4,50159,78
48365,TX,"Panola County, TX",10208,9799,409,3,56882,89
48367,TX,"Parker County, TX",67332,65373,1959,2,82501,129
48369,TX,"Parmer County, TX",4897,4787,110,3,50607,79
48371,TX,"Pecos County, TX",6397,6188,209,5,52763,82
48373,TX,"Polk County, TX",18023,17171,852,3,50416,79
48375,TX,"Potter County, TX",55183,53668,1515,7,41138,64
48377,TX,"Presidio County, TX",3104,2902,202,3,33499,52
48379,TX,"Rains County, TX",6044,5862,182,2,65657,103
48381,TX,"Randall County, TX",72066,70315,1751,3,70694,110
48383,TX,"Reagan County, TX",1909,1861,48,4,67384,105
48385,TX,"Real County, TX",1062,1020,42,5,40834,64
48387,TX,"Red River County, TX",5108,4873,235,2,41325,65
48389,TX,"Reeves County, TX",11403,11209,194,4,48990,77
48391,TX,"Refugio County, TX",3154,3036,118,3,46883,73
48393,TX,"Roberts County, TX",418,405,13,4,70705,110
48395,TX,"Robertson County, TX",7656,7383,273,3,47016,73
48397,TX,"Rockwall County, TX",52083,50482,1601,3,105763,165
48399,TX,"Runnels County, TX",4604,4475,129,4,48650,76
48401,TX,"Rusk County, TX",23074,22251,823,7,56036,88
48403,TX,"Sabine County, TX",3737,3490,247,5,43778,68
48405,TX,"San Augustine County, TX",3402,3240,162,5,40094,63
48407,TX,"San Jacinto County, TX",11749,11211,538,5,42633,67
48409,TX,"San Patricio County, TX",29906,28278,1628,3,57302,90
48411,TX,"San Saba County, TX",2569,2494,75,3,46061,72
48413,TX,"Schleicher County, TX",1323,1285,38,3,53286,83
48415,TX,"Scurry County, TX",6736,6518,218,2,56299,88
48417,TX,"Shackelford County, TX",1910,1868,42,4,65095,102
48419,TX,"Shelby County, TX",11178,10738,440,2,39708,62
48421,TX,"Sherman County, TX",1379,1347,32,3,55473,87
48423,TX,"Smith County, TX",107171,103584,3587,4,59538,93
48425,TX,"Somervell County, TX",4364,4209,155,10,67897,106
48427,TX,"Starr County, TX",25227,22745,2482,3,32516,51
48429,TX,"Stephens County, TX",4109,3983,126,3,46658,73
48431,TX,"Sterling County, TX",579,561,18,3,66790,104
48433,TX,"Stonewall County, TX",588,571,17,4,48267,75
48435,TX,"Sutton County, TX",1414,1361,53,4,63427,99
48437,TX,"Swisher County, TX",2628,2531,97,3,44388,69
48439,TX,"Tarrant County, TX",1082571,1046916,35655,3,70130,110
48441,TX,"Taylor County, TX",66926,65005,1921,3,54465,85
48443,TX,"Terrell County, TX",377,364,13,4,45677,71
48445,TX,"Terry County, TX",5006,4823,183,4,42953,67
48447,TX,"Throckmorton County, TX",656,631,25,4,42746,67
48449,TX,"Titus County, TX",12976,12435,541,3,49924,78
48451,TX,"Tom Green County, TX",54568,52917,1651,3,54774,86
48453,TX,"Travis County, TX",741101,722054,19047,5,80690,126
48455,TX,"Trinity County, TX",5317,5064,253,6,43788,68
48457,TX,"Tyler County, TX",7156,6744,412,4,48254,75
48459,TX,"Upshur County, TX",17914,17251,663,3,53078,83
48461,TX,"Upton County, TX",1675,1626,49,4,58908,92
48463,TX,"Uvalde County, TX",11501,11065,436,3,44690,70
48465,TX,"Val Verde County, TX",22932,22162,770,3,45034,70
48467,TX,"Van Zandt County, TX",26082,25233,849,3,55554,87
48469,TX,"Victoria County, TX",42854,41380,1474,4,57344,90
48471,TX,"Walker County, TX",24150,23214,936,4,47519,74
48473,TX,"Waller County, TX",23475,22597,878,2,61822,97
48475,TX,"Ward County, TX",7488,7316,172,3,61396,96
48477,TX,"Washington County, TX",15155,14656,499,4,59039,92
48479,TX,"Webb County, TX",118626,114247,4379,3,52576,82
48481,TX,"Wharton County, TX",21670,20935,735,3,49901,78
48483,TX,"Wheeler County, TX",2279,2210,69,3,58544,91
48485,TX,"Wichita County, TX",56362,54574,1788,4,51535,81
48487,TX,"Wilbarger County, TX",4975,4798,177,8,42570,67
48489,TX,"Willacy County, TX",6592,6052,540,3,35821,56
48491,TX,"Williamson County, TX",313899,305127,8772,3,92661,145
48493,TX,"Wilson County, TX",24876,24174,702,3,76905,120
48495,TX,"Winkler County, TX",4026,3913,113,3,64894,101
48497,TX,"Wise County, TX",31891,30864,1027,4,70468,110
48499,TX,"Wood County, TX",17693,17008,685,3,56945,89
48501,TX,"Yoakum County, TX",3750,3641,109,3,62636,98
48503,TX,"Young County, TX",8040,7802,238,5,52643,82
48505,TX,"Zapata County, TX",5045,4787,258,9,36069,56
48507,TX,"Zavala County, TX",3334,3050,284,3,32538,51
49001,UT,"Beaver County, UT",2869,2783,86,3,58309,77
49003,UT,"Box Elder County, UT",25904,25222,682,2,69380,92
49005,UT,"Cache County, UT",64176,62779,1397,4,63180,84
49007,UT,"Carbon County, UT",8517,8202,315,4,52110,69
49009,UT,"Daggett County, UT",393,378,15,2,63433,84
49011,UT,"Davis County, UT",173800,169589,4211,4,87610,116
49013,UT,"Duchesne County, UT",7762,7457,305,4,59437,79
49015,UT,"Emery County, UT",4312,4139,173,6,61893,82
49017,UT,"Garfield County, UT",2784,2611,173,4,54625,72
49019,UT,"Grand County, UT",6195,5953,242,3,53535,71
49021,UT,"Iron County, UT",24030,23326,704,3,58307,77
49023,UT,"Juab County, UT",5720,5576,144,3,66056,87
49025,UT,"Kane County, UT",3818,3707,111,3,55887,74
49027,UT,"Millard County, UT",5997,5832,165,2,59069,78
49029,UT,"Morgan County, UT",5563,5428,135,5,101943,135
49031,UT,"Piute County, UT",482,459,23,3,42196,56
49033,UT,"Rich County, UT",1172,1136,36,3,64583,85
49035,UT,"Salt Lake County, UT",634741,618767,15974,5,79941,106
49037,UT,"San Juan County, UT",5725,5435,290,3,49438,65
49039,UT,"Sanpete County, UT",12479,12081,398,3,54648,72
49041,UT,"Sevier County, UT",9741,9438,303,2,58983,78
49043,UT,"Summit County, UT",25039,24427,612,3,112482,149
49045,UT,"Tooele County, UT",34002,33024,978,4,80196,106
49047,UT,"Uintah County, UT",13671,13096,575,2,62541,83
49049,UT,"Utah County, UT",307609,300283,7326,3,79505,105
49051,UT,"Wasatch County, UT",16141,15705,436,3,92136,122
49053,UT,"Washington County, UT",76056,73806,2250,6,64388,85
49055,UT,"Wayne County, UT",1417,1339,78,3,50555,67
49057,UT,"Weber County, UT",127579,123806,3773,2,71835,95
50001,VT,"Addison County, VT",20566,20091,475,3,73574,116
50003,VT,"Bennington County, VT",18070,17539,531,3,56948,90
50005,VT,"Caledonia County, VT",14460,14030,430,2,50942,81
50007,VT,"Chittenden County, VT",96435,94707,1728,3,76483,121
50009,VT,"Essex County, VT",2682,2595,87,2,45796,72
50011,VT,"Franklin County, VT",27313,26674,639,3,65056,103
50013,VT,"Grand Isle County, VT",4041,3925,116,3,68364,108
50015,VT,"Lamoille County, VT",13888,13454,434,2,60555,96
50017,VT,"Orange County, VT",15905,15527,378,4,59758,94
50019,VT,"Orleans County, VT",13275,12713,562,3,48826,77
50021,VT,"Rutland County, VT",30446,29608,838,2,51903,82
50023,VT,"Washington County, VT",34360,33586,774,3,65879,104
50025,VT,"Windham County, VT",21977,21416,561,2,52068,82
50027,VT,"Windsor County, VT",28809,28205,604,3,61843,98
51001,VA,"Accomack County, VA",16708,16117,591,3,47335,62
51003,VA,"Albemarle County, VA",57688,56256,1432,3,86332,113
51005,VA,"Alleghany County, VA",6915,6677,238,3,53341,70
51007,VA,"Amelia County, VA",6323,6123,200,3,60096,79
51009,VA,"Amherst County, VA",15136,14651,485,4,56218,74
51011,VA,"Appomattox County, VA",7209,6959,250,2,54609,71
51013,VA,"Arlington County, VA",155769,152803,2966,2,118986,156
51015,VA,"Augusta County, VA",37722,36806,916,3,63621,83
51017,VA,"Bath County, VA",2509,2447,62,3,54385,71
51019,VA,"Bedford County, VA",38712,37606,1106,3,66591,87
51021,VA,"Bland County, VA",2856,2777,79,3,49023,64
51023,VA,"Botetourt County, VA",17494,17049,445,5,74178,97
51025,VA,"Brunswick County, VA",6066,5781,285,6,43835,57
51027,VA,"Buchanan County, VA",6739,6359,380,4,36881,48
51029,VA,"Buckingham County, VA",6475,6206,269,3,47202,62
51031,VA,"Campbell County, VA",26165,25349,816,3,48984,64
51033,VA,"Caroline County, VA",15369,14879,490,4,64647,85
51035,VA,"Carroll County, VA",13292,12818,474,3,45698,60
51036,VA,"Charles City County, VA",3692,3566,126,4,56465,74
51037,VA,"Charlotte County, VA",5297,5109,188,3,43001,56
51041,VA,"Chesterfield County, VA",189000,183821,5179,3,81641,107
51043,VA,"Clarke County, VA",7665,7476,189,3,85567,112
51045,VA,"Craig County, VA",2312,2238,74,3,53319,70
51047,VA,"Culpeper County, VA",24818,24175,643,3,79739,104
51049,VA,"Cumberland County, VA",4664,4523,141,5,52005,68
51051,VA,"Dickenson County, VA",4731,4497,234,3,37161,49
51053,VA,"Dinwiddie County, VA",13769,13319,450,4,58474,77
51057,VA,"Essex County, VA",5526,5330,196,2,53538,70
51059,VA,"Fairfax County, VA",641034,626394,14640,2,127898,167
51061,VA,"Fauquier County, VA",37567,36655,912,3,103827,136
51063,VA,"Floyd County, VA",8227,8014,213,2,52277,68
51065,VA,"Fluvanna County, VA",14021,13698,323,3,75089,98
51067,VA,"Franklin County, VA",26522,25742,780,2,61878,81
51069,VA,"Frederick County, VA",48459,47290,1169,3,83672,109
51071,VA,"Giles County, VA",7927,7669,258,3,53111,70
51073,VA,"Gloucester County, VA",19705,19198,507,3,71715,94
51075,VA,"Goochland County, VA",11302,10991,311,3,100444,131
51077,VA,"Grayson County, VA",8053,7819,234,2,41312,54
51079,VA,"Greene County, VA",10578,10331,247,3,73345,96
51081,VA,"Greensville County, VA",4307,4160,147,4,47315,62
51083,VA,"Halifax County, VA",15682,15066,616,2,42619,56
51085,VA,"Hanover County, VA",59705,58264,1441,3,90824,119
51087,VA,"Henrico County, VA",183486,178372,5114,3,68975,90
51089,VA,"Henry County, VA",23868,23069,799,3,41908,55
51091,VA,"Highland County, VA",1248,1214,34,3,45917,60
51093,VA,"Isle of Wight County, VA",19570,19017,553,3,78749,103
51095,VA,"James City County, VA",36841,35860,981,3,92773,121
51097,VA,"King and Queen County, VA",3871,3763,108,3,54185,71
51099,VA,"King George County, VA",13515,13157,358,3,85657,112
51101,VA,"King William County, VA",9228,8976,252,4,73035,96
51103,VA,"Lancaster County, VA",5464,5230,234,4,55072,72
51105,VA,"Lee County, VA",8306,7967,339,2,35878,47
51107,VA,"Loudoun County, VA",224573,219414,5159,3,151806,199
51109,VA,"Louisa County, VA",20049,19517,532,3,64135,84
51111,VA,"Lunenburg County, VA",5338,5169,169,2,44860,59
51113,VA,"Madison County, VA",7461,7295,166,3,66397,87
51115,VA,"Mathews County, VA",4169,4048,121,4,69112,90
51117,VA,"Mecklenburg County, VA",12613,12105,508,3,43128,56
51119,VA,"Middlesex County, VA",5319,5181,138,3,58834,77
51121,VA,"Montgomery County, VA",50364,48937,1427,3,58740,77
51125,VA,"Nelson County, VA",7508,7300,208,2,55804,73
51127,VA,"New Kent County, VA",12577,12277,300,4,102619,134
51131,VA,"Northampton County, VA",5485,5241,244,4,45235,59
51133,VA,"Northumberland County, VA",5704,5458,246,3,60385,79
51135,VA,"Nottoway County, VA",7298,7095,203,3,45913,60
51137,VA,"Orange County, VA",17480,16961,519,4,71691,94
51139,VA,"Page County, VA",12065,11601,464,4,52877,69
51141,VA,"Patrick County, VA",7342,7084,258,3,43568,57
51143,VA,"Pittsylvania County, VA",30210,29191,1019,3,51682,68
51145,VA,"Powhatan County, VA",14253,13892,361,4,94293,123
51147,VA,"Prince Edward County, VA",10444,10051,393,3,44586,58
51149,VA,"Prince George County, VA",15206,14695,511,3,74518,97
51153,VA,"Prince William County, VA",247826,241558,6268,3,106208,139
51155,VA,"Pulaski County, VA",16149,15594,555,3,54086,71
51157,VA,"Rappahannock County, VA",3727,3633,94,3,79086,103
51159,VA,"Richmond County, VA",4097,3976,121,3,49758,65
51161,VA,"Roanoke County, VA",49611,48349,1262,3,71742,94
51163,VA,"Rockbridge County, VA",10819,10523,296,2,58501,77
51165,VA,"Rockingham County, VA",42151,41146,1005,4,67242,88
51167,VA,"Russell County, VA",11227,10754,473,3,40345,53
51169,VA,"Scott County, VA",9149,8863,286,3,41288,54
51171,VA,"Shenandoah County, VA",22426,21863,563,4,59087,77
51173,VA,"Smyth County, VA",13811,13296,515,3,41964,55
51175,VA,"Southampton County, VA",9139,8895,244,3,62327,82
51177,VA,"Spotsylvania County, VA",67663,65697,1966,3,90262,118
51179,VA,"Stafford County, VA",72712,70711,2001,3,109090,143
51181,VA,"Surry County, VA",3695,3568,127,5,59069,77
51183,VA,"Sussex County, VA",3833,3660,173,4,45134,59
51185,VA,"Tazewell County, VA",15748,15060,688,3,43619,57
51187,VA,"Warren County, VA",20611,20032,579,3,69878,91
51191,VA,"Washington County, VA",26806,25919,887,4,52387,69
51193,VA,"Westmoreland County, VA",9538,9204,334,5,54885,72
51195,VA,"Wise County, VA",13432,12809,623,4,42372,55
51197,VA,"Wythe County, VA",13776,13282,494,3,48543,64
51199,VA,"York County, VA",32989,32110,879,2,91535,120
51510,VA,"Alexandria city, VA",102254,100093,2161,4,102589,134
51520,VA,"Bristol city, VA",7218,6946,272,3,37678,49
51530,VA,"Buena Vista city, VA",3436,3342,94,2,44752,59
51540,VA,"Charlottesville city, VA",26642,26011,631,3,58717,77
51550,VA,"Chesapeake city, VA",123523,119957,3566,3,77361,101
51570,VA,"Colonial Heights city, VA",8877,8593,284,4,57688,75
51580,VA,"Covington city, VA",2393,2293,100,5,41842,55
51590,VA,"Danville city, VA",19226,18261,965,5,36073,47
51595,VA,"Emporia city, VA",2303,2189,114,2,38631,51
51600,VA,"Fairfax city, VA",13573,13284,289,2,106430,139
51610,VA,"Falls Church city, VA",8676,8499,177,4,137849,180
51620,VA,"Franklin city, VA",3598,3453,145,3,45433,59
51630,VA,"Fredericksburg city, VA",14282,13803,479,3,62121,81
51640,VA,"Galax city, VA",2932,2836,96,4,37229,49
51650,VA,"Hampton city, VA",64807,62353,2454,3,55816,73
51660,VA,"Harrisonburg city, VA",25153,24345,808,4,48189,63
51670,VA,"Hopewell city, VA",9757,9341,416,5,38293,50
51678,VA,"Lexington city, VA",2099,2001,98,4,54204,71
51680,VA,"Lynchburg city, VA",36598,35238,1360,3,50612,66
51683,VA,"Manassas city, VA",22253,21696,557,3,84405,110
51685,VA,"Manassas Park city, VA",9462,9228,234,4,83145,109
51690,VA,"Martinsville city, VA",5501,5274,227,4,37814,49
51700,VA,"Newport News city, VA",89406,86310,3096,4,53022,69
51710,VA,"Norfolk city, VA",112364,108487,3877,4,52437,69
51720,VA,"Norton city, VA",1687,1625,62,6,38062,50
51730,VA,"Petersburg city, VA",13129,12396,733,2,40240,53
51735,VA,"Poquoson city, VA",6427,6271,156,4,98217,128
51740,VA,"Portsmouth city, VA",44566,42831,1735,4,50411,66
51750,VA,"Radford city, VA",8688,8377,311,3,41530,54
51760,VA,"Richmond city, VA",119265,115360,3905,3,50949,67
51770,VA,"Roanoke city, VA",49397,47900,1497,3,45534,60
51775,VA,"Salem city, VA",13037,12677,360,3,54888,72
51790,VA,"Staunton city, VA",12314,11986,328,3,54296,71
51800,VA,"Suffolk city, VA",44928,43564,1364,3,77847,102
51810,VA,"Virginia Beach city, VA",234597,228266,6331,3,78491,103
51820,VA,"Waynesboro city, VA",10762,10451,311,4,44619,58
51830,VA,"Williamsburg city, VA",6736,6475,261,3,56569,74
51840,VA,"Winchester city, VA",14892,14480,412,4,60254,79
53001,WA,"Adams County, WA",9870,9312,558,4,53535,68
53003,WA,"Asotin County, WA",10400,9969,431,5,54776,70
53005,WA,"Benton County, WA",103169,97773,5396,5,72847,93
53007,WA,"Chelan County, WA",45113,42911,2202,7,59838,76
53009,WA,"Clallam County, WA",28886,26980,1906,5,57571,73
53011,WA,"Clark County, WA",241901,230422,11479,6,80407,102
53013,WA,"Columbia County, WA",1848,1747,101,6,56338,72
53015,WA,"Cowlitz County, WA",47949,45086,2863,6,57316,73
53017,WA,"Douglas County, WA",21968,20731,1237,11,63086,80
53019,WA,"Ferry County, WA",2499,2216,283,6,47463,60
53021,WA,"Franklin County, WA",43132,40383,2749,5,63575,81
53023,WA,"Garfield County, WA",918,868,50,7,54555,69
53025,WA,"Grant County, WA",46990,43751,3239,7,57152,73
53027,WA,"Grays Harbor County, WA",29008,26961,2047,5,59346,75
53029,WA,"Island County, WA",36116,34294,1822,6,72173,92
53031,WA,"Jefferson County, WA",12938,12209,729,3,60556,77
53033,WA,"King County, WA",1290480,1254638,35842,5,102338,130
53035,WA,"Kitsap County, WA",128764,122887,5877,6,79268,101
53037,WA,"Kittitas County, WA",23177,21905,1272,6,59172,75
53039,WA,"Klickitat County, WA",10314,9712,602,6,60567,77
53041,WA,"Lewis County, WA",34996,32841,2155,5,58525,74
53043,WA,"Lincoln County, WA",5031,4779,252,6,60849,77
53045,WA,"Mason County, WA",25325,23733,1592,7,63689,81
53047,WA,"Okanogan County, WA",20346,18964,1382,7,44777,57
53049,WA,"Pacific County, WA",8603,8007,596,8,50521,64
53051,WA,"Pend Oreille County, WA",5074,4674,400,5,51950,66
53053,WA,"Pierce County, WA",442094,419394,22700,4,78779,100
53055,WA,"San Juan County, WA",8674,8349,325,5,69113,88
53057,WA,"Skagit County, WA",63069,59644,3425,6,67551,86
53059,WA,"Skamania County, WA",5555,5252,303,3,69163,88
53061,WA,"Snohomish County, WA",439464,426100,13364,5,89119,113
53063,WA,"Spokane County, WA",255027,241655,13372,7,59976,76
53065,WA,"Stevens County, WA",19062,17726,1336,5,55000,70
53067,WA,"Thurston County, WA",142896,135982,6914,7,77890,99
53069,WA,"Wahkiakum County, WA",1375,1283,92,5,61123,78
53071,WA,"Walla Walla County, WA",30252,28760,1492,5,60202,77
53073,WA,"Whatcom County, WA",115413,109672,5741,4,68656,87
53075,WA,"Whitman County, WA",23996,22958,1038,7,45906,58
53077,WA,"Yakima County, WA",132466,123185,9281,5,55674,71
54001,WV,"Barbour County, WV",7189,6760,429,4,39710,82
54003,WV,"Berkeley County, WV",58635,56569,2066,6,63012,130
54005,WV,"Boone County, WV",7443,7036,407,7,43697,90
54007,WV,"Braxton County, WV",5245,4857,388,5,39651,82
54009,WV,"Brooke County, WV",10013,9488,525,4,50900,105
54011,WV,"Cabell County, WV",41620,39889,1731,13,42125,87
54013,WV,"Calhoun County, WV",2558,2226,332,9,37307,77
54015,WV,"Clay County, WV",3148,2879,269,4,41923,86
54017,WV,"Doddridge County, WV",4011,3834,177,6,50642,104
54019,WV,"Fayette County, WV",16286,15363,923,7,41430,85
54021,WV,"Gilmer County, WV",2384,2221,163,6,40373,83
54023,WV,"Grant County, WV",5959,5632,327,5,47400,97
54025,WV,"Greenbrier County, WV",16005,15266,739,4,43564,90
54027,WV,"Hampshire County, WV",10799,10384,415,5,54811,113
54029,WV,"Hancock County, WV",13094,12418,676,5,51017,105
54031,WV,"Hardy County, WV",5804,5507,297,4,46658,96
54033,WV,"Harrison County, WV",34765,33229,1536,5,53909,111
54035,WV,"Jackson County, WV",13478,12808,670,3,50808,104
54037,WV,"Jefferson County, WV",30464,29527,937,5,75225,155
54039,WV,"Kanawha County, WV",82440,78647,3793,6,48334,99
54041,WV,"Lewis County, WV",6851,6428,423,6,46895,96
54043,WV,"Lincoln County, WV",7213,6757,456,6,43198,89
54045,WV,"Logan County, WV",11157,10492,665,9,38533,79
54047,WV,"McDowell County, WV",4451,4041,410,5,29106,60
54049,WV,"Marion County, WV",25621,24324,1297,6,51300,105
54051,WV,"Marshall County, WV",14268,13366,902,6,53145,109
54053,WV,"Mason County, WV",10227,9615,612,6,47753,98
54055,WV,"Mercer County, WV",21036,19843,1193,6,41794,86
54057,WV,"Mineral County, WV",12701,11980,721,7,49704,102
54059,WV,"Mingo County, WV",6894,6422,472,4,34698,71
54061,WV,"Monongalia County, WV",54746,52749,1997,4,55652,114
54063,WV,"Monroe County, WV",5979,5718,261,4,44655,92
54065,WV,"Morgan County, WV",8191,7874,317,6,50660,104
54067,WV,"Nicholas County, WV",9521,8920,601,5,40023,82
54069,WV,"Ohio County, WV",21367,20407,960,4,50390,104
54071,WV,"Pendleton County, WV",3701,3559,142,7,43451,89
54073,WV,"Pleasants County, WV",2924,2724,200,6,54972,113
54075,WV,"Pocahontas County, WV",3891,3670,221,5,39454,81
54077,WV,"Preston County, WV",15617,14904,713,4,50821,104
54079,WV,"Putnam County, WV",26795,25630,1165,5,66991,138
54081,WV,"Raleigh County, WV",30525,29093,1432,6,45386,93
54083,WV,"Randolph County, WV",12352,11617,735,6,46285,95
54085,WV,"Ritchie County, WV",4405,4156,249,10,46131,95
54087,WV,"Roane County, WV",5145,4654,491,6,41671,86
54089,WV,"Summers County, WV",4340,4102,238,5,37000,76
54091,WV,"Taylor County, WV",7920,7537,383,5,48294,99
54093,WV,"Tucker County, WV",3361,3186,175,8,47222,97
54095,WV,"Tyler County, WV",3145,2900,245,6,48345,99
54097,WV,"Upshur County, WV",9613,9040,573,5,45074,93
54099,WV,"Wayne County, WV",15838,14983,855,6,42095,87
54101,WV,"Webster County, WV",3326,3116,210,7,34385,71
54103,WV,"Wetzel County, WV",6656,6174,482,8,46824,96
54105,WV,"Wirt County, WV",2303,2122,181,5,48627,100
54107,WV,"Wood County, WV",36845,34970,1875,7,49209,101
54109,WV,"Wyoming County, WV",6706,6240,466,3,42761,88
55001,WI,"Adams County, WI",8153,7733,420,5,53156,83
55003,WI,"Ashland County, WI",7915,7536,379,4,47202,74
55005,WI,"Barron County, WI",24406,23428,978,6,54372,85
55007,WI,"Bayfield County, WI",7591,7165,426,3,58065,91
55009,WI,"Brown County, WI",141886,137489,4397,4,65494,102
55011,WI,"Buffalo County, WI",6466,6194,272,5,58407,91
55013,WI,"Burnett County, WI",7133,6752,381,3,51519,80
55015,WI,"Calumet County, WI",27565,26791,774,4,80354,125
55017,WI,"Chippewa County, WI",33181,31909,1272,3,60713,95
55019,WI,"Clark County, WI",17737,17151,586,3,54296,85
55021,WI,"Columbia County, WI",31587,30606,981,4,69219,108
55023,WI,"Crawford County, WI",7622,7297,325,2,51919,81
55025,WI,"Dane County, WI",321677,313824,7853,3,77828,121
55027,WI,"Dodge County, WI",47544,46107,1437,4,61730,96
55029,WI,"Door County, WI",15288,14706,582,4,64217,100
55031,WI,"Douglas County, WI",23029,22058,971,4,55651,87
55033,WI,"Dunn County, WI",24111,23257,854,3,61506,96
55035,WI,"Eau Claire County, WI",58872,57071,1801,5,64972,101
55037,WI,"Florence County, WI",2221,2115,106,3,58270,91
55039,WI,"Fond du Lac County, WI",57386,55701,1685,5,65905,103
55041,WI,"Forest County, WI",4012,3803,209,3,48964,76
55043,WI,"Grant County, WI",27861,26962,899,3,56418,88
55045,WI,"Green County, WI",21049,20441,608,4,64319,100
55047,WI,"Green Lake County, WI",9456,9086,370,3,59458,93
55049,WI,"Iowa County, WI",13731,13334,397,6,67390,105
55051,WI,"Iron County, WI",2542,2388,154,4,48813,76
55053,WI,"Jackson County, WI",10276,9876,400,3,57247,89
55055,WI,"Jefferson County, WI",45857,44416,1441,3,71098,111
55057,WI,"Juneau County, WI",13446,12999,447,4,55787,87
55059,WI,"Kenosha County, WI",89403,85858,3545,3,66460,104
55061,WI,"Kewaunee County, WI",11042,10686,356,3,65879,103
55063,WI,"La Crosse County, WI",66318,64391,1927,3,59758,93
55065,WI,"Lafayette County, WI",10099,9829,270,4,59128,92
55067,WI,"Langlade County, WI",9321,8932,389,4,49597,77
55069,WI,"Lincoln County, WI",15071,14509,562,3,60728,95
55071,WI,"Manitowoc County, WI",40987,39589,1398,3,61326,96
55073,WI,"Marathon County, WI",73551,71419,2132,5,66092,103
55075,WI,"Marinette County, WI",19466,18573,893,4,54404,85
55077,WI,"Marquette County, WI",7714,7409,305,8,56790,89
55078,WI,"Menominee County, WI",1629,1498,131,4,40300,63
55079,WI,"Milwaukee County, WI",466908,448251,18657,3,53505,83
55081,WI,"Monroe County, WI",23377,22672,705,4,60296,94
55083,WI,"Oconto County, WI",20575,19830,745,4,66401,104
55085,WI,"Oneida County, WI",17846,17071,775,3,62765,98
55087,WI,"Outagamie County, WI",103135,100059,3076,3,66994,104
55089,WI,"Ozaukee County, WI",49030,47625,1405,4,90446,141
55091,WI,"Pepin County, WI",4147,3991,156,3,62675,98
55093,WI,"Pierce County, WI",25369,24504,865,4,75368,117
55095,WI,"Polk County, WI",24519,23519,1000,3,63910,100
55097,WI,"Portage County, WI",38592,37327,1265,4,58248,91
55099,WI,"Price County, WI",6493,6207,286,4,48761,76
55101,WI,"Racine County, WI",98585,94556,4029,3,61691,96
55103,WI,"Richland County, WI",9219,8926,293,4,51295,80
55105,WI,"Rock County, WI",85330,82147,3183,5,61624,96
55107,WI,"Rusk County, WI",6723,6393,330,3,49860,78
55109,WI,"St. Croix County, WI",50446,48754,1692,3,87098,136
55111,WI,"Sauk County, WI",35576,34533,1043,5,63752,99
55113,WI,"Sawyer County, WI",7962,7582,380,3,53908,84
55115,WI,"Shawano County, WI",21024,20342,682,3,58982,92
55117,WI,"Sheboygan County, WI",62144,60436,1708,4,62108,97
55119,WI,"Taylor County, WI",10973,10566,407,4,52419,82
55121,WI,"Trempealeau County, WI",15952,15374,578,3,61687,96
55123,WI,"Vernon County, WI",15278,14772,506,4,56272,88
55125,WI,"Vilas County, WI",10154,9721,433,3,55576,87
55127,WI,"Walworth County, WI",57872,55975,1897,4,64682,101
55129,WI,"Washburn County, WI",7858,7536,322,3,52735,82
55131,WI,"Washington County, WI",77161,74950,2211,3,81928,128
55133,WI,"Waukesha County, WI",224731,218151,6580,3,91070,142
55135,WI,"Waupaca County, WI",25943,25093,850,4,61773,96
55137,WI,"Waushara County, WI",11422,10955,467,3,55476,86
55139,WI,"Winnebago County, WI",91474,88728,2746,4,59643,93
55141,WI,"Wood County, WI",35136,33786,1350,4,57325,89
56001,WY,"Albany County, WY",20216,19595,621,4,52216,79
56003,WY,"Big Horn County, WY",5306,5083,223,4,53018,80
56005,WY,"Campbell County, WY",23242,22389,853,3,83997,127
56007,WY,"Carbon County, WY",7982,7720,262,3,61626,93
56009,WY,"Converse County, WY",8694,8456,238,3,72481,110
56011,WY,"Crook County, WY",3710,3593,117,4,64120,97
56013,WY,"Fremont County, WY",18635,17811,824,4,57953,88
56015,WY,"Goshen County, WY",6625,6387,238,4,55540,84
56017,WY,"Hot Springs County, WY",2176,2099,77,4,52344,79
56019,WY,"Johnson County, WY",4183,4032,151,4,57224,87
56021,WY,"Laramie County, WY",48491,46813,1678,3,69613,105
56023,WY,"Lincoln County, WY",8876,8581,295,4,71269,108
56025,WY,"Natrona County, WY",39348,37804,1544,3,66104,100
56027,WY,"Niobrara County, WY",1239,1205,34,4,48513,73
56029,WY,"Park County, WY",15459,14839,620,3,59494,90
56031,WY,"Platte County, WY",4660,4501,159,4,57425,87
56033,WY,"Sheridan County, WY",15653,15111,542,4,64030,97
56035,WY,"Sublette County, WY",4129,3947,182,4,78055,118
56037,WY,"Sweetwater County, WY",21274,20446,828,3,80639,122
56039,WY,"Teton County, WY",15575,15151,424,4,98837,149
56041,WY,"Uinta County, WY",9035,8682,353,4,70756,107
56043,WY,"Washakie County, WY",3941,3786,155,3,55122,83
56045,WY,"Weston County, WY",3811,3701,110,8,59410,90